AAAAATGTGGG: AAAATGTGGGA 
AAAACGCGACA: AAACGCGACAA 
AAAACTTCTTT: AAACTTCTTTT 
AAAAGGTAATT: AAAGGTAATTA 
AAAATGCAAGA: AAATGCAAGAA 
AAAATGTGGGA: AAATGTGGGAA 
AAAATTTACAT: AAATTTACATT 
AAACAATGGGT: AACAATGGGTT 
AAACATAGGAT: AACATAGGATC 
AAACCTCTAGT: AACCTCTAGTG 
AAACGCGACAA: AACGCGACAAC 
AAACGCGTCCG: AACGCGTCCGG 
AAACTTCTTTT: AACTTCTTTTC 
AAAGAAGGAGC: AAGAAGGAGCC 
AAAGGAAGGGT: AAGGAAGGGTG 
AAAGGCGAAGG: AAGGCGAAGGT 
AAAGGTAATTA: AAGGTAATTAT 
AAAGTCTCTTA: AAGTCTCTTAC 
AAATCACAAAT: AATCACAAATT 
AAATCAGAAGA: AATCAGAAGAC 
AAATGCAAGAA: AATGCAAGAAC 
AAATGCACTTA: AATGCACTTAG 
AAATGTGGGAA: AATGTGGGAAG 
AAATTCACGCG: AATTCACGCGT 
AAATTGATGGC: AATTGATGGCG 
AAATTTACATT: AATTTACATTG 
AACAACGTCAG: ACAACGTCAGC 
AACAATGGGTT: ACAATGGGTTA 
AACACTAATTC: ACACTAATTCT 
AACAGTACCTT: ACAGTACCTTA 
AACATAGGATC: ACATAGGATCC 
AACATTTGAAC: ACATTTGAACT 
AACCAAAACTT: ACCAAAACTTC 
AACCCACATCC: ACCCACATCCA 
AACCCCAGGAA: ACCCCAGGAAA 
AACCTAGCTCA: ACCTAGCTCAG 
AACCTCTAGTG: ACCTCTAGTGA 
AACGACCAGAT: ACGACCAGATT 
AACGACGTACC: ACGACGTACCG 
AACGATGCAAG: ACGATGCAAGC 
AACGCGACAAC: ACGCGACAACG 
AACGCGTCCGG: ACGCGTCCGGT 
AACGGTGGGCA: ACGGTGGGCAG 
AACGTATTCCC: ACGTATTCCCG 
AACGTCAGCCC: ACGTCAGCCCC 
AACGTGCCTCT: ACGTGCCTCTC 
AACTAAGCTTT: ACTAAGCTTTG 
AACTGCTACGC: ACTGCTACGCG 
AACTGCTGTCA: ACTGCTGTCAC 
AACTGTAGTGC: ACTGTAGTGCC 
AACTTCTTTTC: ACTTCTTTTCT 
AACTTTGAAAA: ACTTTGAAAAC 
AAGAACCCACA: AGAACCCACAT 
AAGAAGGAGCC: AGAAGGAGCCT 
AAGACCCGCCT: AGACCCGCCTG 
AAGAGCATTTA: AGAGCATTTAC 
AAGAGGATAAT: AGAGGATAATG 
AAGAGGGAGCT: AGAGGGAGCTC 
AAGAGGTTCTG: AGAGGTTCTGG 
AAGATATACCA: AGATATACCAA 
AAGCCCCCAGG: AGCCCCCAGGG 
AAGCCCGAGCC: AGCCCGAGCCT 
AAGCCGATACC: AGCCGATACCG 
AAGCCGTAGAC: AGCCGTAGACA 
AAGCGGTGCAT: AGCGGTGCATA 
AAGCTAAACAT: AGCTAAACATA 
AAGCTGATCTG: AGCTGATCTGG 
AAGCTTTGACT: AGCTTTGACTG 
AAGGAAGGGTG: AGGAAGGGTGA 
AAGGAGCCTTG: AGGAGCCTTGG 
AAGGCGAAGGT: AGGCGAAGGTG 
AAGGGGAGTAT: AGGGGAGTATT 
AAGGGGGGGCT: AGGGGGGGCTG 
AAGGGTCAGTA: AGGGTCAGTAC 
AAGGGTGACCT: AGGGTGACCTC 
AAGGTAATTAT: AGGTAATTATA 
AAGGTCTAGCT: AGGTCTAGCTA 
AAGGTGAATTA: AGGTGAATTAA 
AAGTATCGTGG: AGTATCGTGGA 
AAGTCGGCACG: AGTCGGCACGT 
AAGTCGTACCT: AGTCGTACCTC 
AAGTCTCTTAC: AGTCTCTTACA 
AAGTGATGGAA: AGTGATGGAAT 
AAGTTCTCCCA: AGTTCTCCCAC 
AAGTTTTCAGG: AGTTTTCAGGC 
AATAACAACGT: ATAACAACGTC 
AATACCTGAGG: ATACCTGAGGG 
AATACGAACGA: ATACGAACGAC 
AATACGAGCAC: ATACGAGCACA 
AATACTAATGA: ATACTAATGAG 
AATCACAAATT: ATCACAAATTC 
AATCAGAAGAC: ATCAGAAGACC 
AATCCAAATCA: ATCCAAATCAC 
AATCCCTATTC: ATCCCTATTCC 
AATCCTGAACC: ATCCTGAACCA 
AATCGCGAACG: ATCGCGAACGA 
AATCTCTGATG: ATCTCTGATGA 
AATCTTTCATG: ATCTTTCATGA 
AATGAGGGTTT: ATGAGGGTTTG 
AATGCAAGAAC: ATGCAAGAACC 
AATGCACTTAG: ATGCACTTAGT 
AATGCAGGTCG: ATGCAGGTCGG 
AATGGGTTAAA: ATGGGTTAAAT 
AATGGTAGCTT: ATGGTAGCTTC 
AATGTGGGAAG: ATGTGGGAAGT 
AATGTTGCACG: ATGTTGCACGG 
AATTAATTTAT: ATTAATTTATT 
AATTAGGTGTT: ATTAGGTGTTG 
AATTAGTTACC: ATTAGTTACCG 
AATTATATTCC: ATTATATTCCG 
AATTCACGCGT: ATTCACGCGTA 
AATTCTCTTGC: ATTCTCTTGCT 
AATTCTTGGAG: ATTCTTGGAGT 
AATTGATGGCG: ATTGATGGCGC 
AATTGATTGAA: ATTGATTGAAC 
AATTGCACATG: ATTGCACATGT 
AATTTACATTG: ATTTACATTGG 
AATTTATTATA: ATTTATTATAA 
AATTTTCGGAA: ATTTTCGGAAC 
ACAAACGCGTC: CAAACGCGTCC 
ACAAATTCACG: CAAATTCACGC 
ACAACGTCAGC: CAACGTCAGCC 
ACAACGTGCCT: CAACGTGCCTC 
ACAAGATATAC: CAAGATATACC 
ACAATCTCTGA: CAATCTCTGAT 
ACAATGGGTTA: CAATGGGTTAA 
ACACCCAGTCG: CACCCAGTCGC 
ACACCTGTGTA: CACCTGTGTAT 
ACACTAATTCT: CACTAATTCTC 
ACACTGCGTTA: CACTGCGTTAT 
ACAGGAAACAA: CAGGAAACAAT 
ACAGGGACCCC: CAGGGACCCCA 
ACAGGGCACAC: CAGGGCACACC 
ACAGGGGAGCA: CAGGGGAGCAC 
ACAGTACCTTA: CAGTACCTTAG 
ACAGTTCTACA: CAGTTCTACAT 
ACATAACCTAG: CATAACCTAGC 
ACATAGGATCC: CATAGGATCCT 
ACATCATACGT: CATCATACGTA 
ACATCCATCGA: CATCCATCGAC 
ACATGTGGGGG: CATGTGGGGGG 
ACATGTGTTCA: CATGTGTTCAG 
ACATTCGCGGA: CATTCGCGGAT 
ACATTGGTCTG: CATTGGTCTGA 
ACATTTGAACT: CATTTGAACTT 
ACCAAAACTTC: CCAAAACTTCT 
ACCAATACTAA: CCAATACTAAT 
ACCAATCCCTA: CCAATCCCTAT 
ACCACGTCCGT: CCACGTCCGTG 
ACCAGATTTCA: CCAGATTTCAT 
ACCAGTGTTCG: CCAGTGTTCGA 
ACCCACATCCA: CCCACATCCAT 
ACCCAGTCGCA: CCCAGTCGCAG 
ACCCCACGAAC: CCCCACGAACT 
ACCCCAGGAAA: CCCCAGGAAAC 
ACCCGCCTGGA: CCCGCCTGGAC 
ACCCTCGACAA: CCCTCGACAAA 
ACCCTTTTCTA: CCCTTTTCTAT 
ACCGAATTAGG: CCGAATTAGGT 
ACCGCCAACAG: CCGCCAACAGT 
ACCGCGGGACG: CCGCGGGACGA 
ACCGGTGTCCG: CCGGTGTCCGA 
ACCGTAATTAG: CCGTAATTAGT 
ACCGTCCGGTC: CCGTCCGGTCC 
ACCTAATGCAG: CCTAATGCAGG 
ACCTAGCTCAG: CCTAGCTCAGC 
ACCTCGTAATA: CCTCGTAATAC 
ACCTCGTGGGC: CCTCGTGGGCA 
ACCTCTAGTGA: CCTCTAGTGAA 
ACCTGAGGGTG: CCTGAGGGTGA 
ACCTGTGTATT: CCTGTGTATTT 
ACCTTAGCTTG: CCTTAGCTTGT 
ACCTTCGCTGA: CCTTCGCTGAT 
ACCTTGTTGGG: CCTTGTTGGGT 
ACGAACGACCA: CGAACGACCAG 
ACGAACTGCTA: CGAACTGCTAC 
ACGAAGGTCTA: CGAAGGTCTAG 
ACGACATCATA: CGACATCATAC 
ACGACCAGATT: CGACCAGATTT 
ACGACGTACCG: CGACGTACCGC 
ACGAGCACAGT: CGAGCACAGTT 
ACGAGGACCTT: CGAGGACCTTC 
ACGATACGACA: CGATACGACAT 
ACGATACTAAC: CGATACTAACC 
ACGATCCCGTG: CGATCCCGTGG 
ACGATGCAAGC: CGATGCAAGCC 
ACGATTACGCA: CGATTACGCAC 
ACGCACTTGTT: CGCACTTGTTT 
ACGCCCTTATC: CGCCCTTATCG 
ACGCGACAACG: CGCGACAACGT 
ACGCGCCACGT: CGCGCCACGTG 
ACGCGCCTACC: CGCGCCTACCG 
ACGCGTAACCC: CGCGTAACCCC 
ACGCGTAAGAG: CGCGTAAGAGG 
ACGCGTATGTC: CGCGTATGTCC 
ACGCGTCCGGG: CGCGTCCGGGT 
ACGCGTCCGGT: CGCGTCCGGTC 
ACGCTTACGTT: CGCTTACGTTC 
ACGGAAAGGCG: CGGAAAGGCGA 
ACGGCGCGGGA: CGGCGCGGGAT 
ACGGGTTCTTG: CGGGTTCTTGT 
ACGGTGCTTAG: CGGTGCTTAGA 
ACGGTGGGCAG: CGGTGGGCAGA 
ACGTACCGCCA: CGTACCGCCAA 
ACGTATCGGGT: CGTATCGGGTC 
ACGTATTCCCG: CGTATTCCCGG 
ACGTCAGCCCC: CGTCAGCCCCG 
ACGTCCGTGAC: CGTCCGTGACG 
ACGTGCCTCTC: CGTGCCTCTCC 
ACGTGTCAGTG: CGTGTCAGTGC 
ACGTTAGAGAA: CGTTAGAGAAA 
ACGTTATTAGG: CGTTATTAGGT 
ACGTTCCGAGA: CGTTCCGAGAG 
ACTAACCGCTT: CTAACCGCTTA 
ACTAACGTATT: CTAACGTATTC 
ACTAAGCTTTG: CTAAGCTTTGA 
ACTAATGAGGG: CTAATGAGGGT 
ACTAATTCTCT: CTAATTCTCTT 
ACTAGAACGGT: CTAGAACGGTG 
ACTATTATGAG: CTATTATGAGT 
ACTCCTTGCCA: CTCCTTGCCAT 
ACTGATTGAGG: CTGATTGAGGT 
ACTGCGTTATC: CTGCGTTATCA 
ACTGCTACGCG: CTGCTACGCGT 
ACTGCTGTCAC: CTGCTGTCACT 
ACTGGACTGGA: CTGGACTGGAG 
ACTGGAGTGAA: CTGGAGTGAAG 
ACTGGGGAATT: CTGGGGAATTT 
ACTGGTTTCCT: CTGGTTTCCTG 
ACTGTAGTGCC: CTGTAGTGCCA 
ACTTAGTCGAG: CTTAGTCGAGC 
ACTTCTTTTCT: CTTCTTTTCTC 
ACTTGTTTTGG: CTTGTTTTGGG 
ACTTTGAAAAC: CTTTGAAAACG 
AGAAAAATGTG: GAAAAATGTGG 
AGAAAATTTAC: GAAAATTTACA 
AGAAAGTCTCT: GAAAGTCTCTT 
AGAACCCACAT: GAACCCACATC 
AGAACGGTGGG: GAACGGTGGGC 
AGAAGACCCGC: GAAGACCCGCC 
AGAAGGAGCCT: GAAGGAGCCTT 
AGACAGGAAAC: GACAGGAAACA 
AGACCCGCCTG: GACCCGCCTGG 
AGACCTTGTTG: GACCTTGTTGG 
AGACGATACTA: GACGATACTAA 
AGAGAAAAATG: GAGAAAAATGT 
AGAGCATTTAC: GAGCATTTACC 
AGAGGATAATG: GAGGATAATGT 
AGAGGGAGCTC: GAGGGAGCTCA 
AGAGGTTCTGG: GAGGTTCTGGA 
AGAGTGATAGA: GAGTGATAGAC 
AGAGTGGACGA: GAGTGGACGAT 
AGAGTTTAGCC: GAGTTTAGCCC 
AGATATACCAA: GATATACCAAT 
AGATATTGTAC: GATATTGTACG 
AGATTTCATCA: GATTTCATCAT 
AGCAATCCTGA: GCAATCCTGAA 
AGCACAGGGAC: GCACAGGGACC 
AGCACAGTTCT: GCACAGTTCTA 
AGCATTTACCC: GCATTTACCCT 
AGCCAAGTTCT: GCCAAGTTCTC 
AGCCCATCAAC: GCCCATCAACT 
AGCCCCCAGGG: GCCCCCAGGGT 
AGCCCCGAAGA: GCCCCGAAGAG 
AGCCCCGAAGC: GCCCCGAAGCT 
AGCCCGAGCCT: GCCCGAGCCTA 
AGCCCTCCCCA: GCCCTCCCCAG 
AGCCGATACCG: GCCGATACCGT 
AGCCGTAGACA: GCCGTAGACAG 
AGCCTAGCGTC: GCCTAGCGTCG 
AGCCTCGGCGC: GCCTCGGCGCG 
AGCCTTGGGTG: GCCTTGGGTGA 
AGCGCAAGTGA: GCGCAAGTGAT 
AGCGGTGCATA: GCGGTGCATAG 
AGCGTCGGTCG: GCGTCGGTCGT 
AGCGTTTGTCT: GCGTTTGTCTG 
AGCTAAACATA: GCTAAACATAG 
AGCTATGGTAG: GCTATGGTAGC 
AGCTCAGCCCA: GCTCAGCCCAT 
AGCTCATGTCT: GCTCATGTCTA 
AGCTGATCTGG: GCTGATCTGGG 
AGCTTACGGAA: GCTTACGGAAA 
AGCTTCTCCTT: GCTTCTCCTTC 
AGCTTGTAGGT: GCTTGTAGGTG 
AGCTTGTTCCT: GCTTGTTCCTC 
AGCTTTGACTG: GCTTTGACTGA 
AGGAAACAATG: GGAAACAATGG 
AGGAAACCTCT: GGAAACCTCTA 
AGGAAGGGTGA: GGAAGGGTGAC 
AGGAATCCAAA: GGAATCCAAAT 
AGGACCTTCGC: GGACCTTCGCT 
AGGACGTTAGA: GGACGTTAGAG 
AGGAGCCTTGG: GGAGCCTTGGG 
AGGAGTCCTGG: GGAGTCCTGGA 
AGGAGTTTGCC: GGAGTTTGCCA 
AGGATAAGGGG: GGATAAGGGGG 
AGGATAATGTT: GGATAATGTTG 
AGGATCCTTAC: GGATCCTTACG 
AGGCGAAGGTG: GGCGAAGGTGA 
AGGCGACCAGT: GGCGACCAGTG 
AGGCGCTTTAA: GGCGCTTTAAA 
AGGGACCCCAC: GGGACCCCACG 
AGGGAGCTCAT: GGGAGCTCATG 
AGGGAGGGGGA: GGGAGGGGGAT 
AGGGCACACCT: GGGCACACCTG 
AGGGGAGCACA: GGGGAGCACAG 
AGGGGAGTATT: GGGGAGTATTT 
AGGGGGATCGA: GGGGGATCGAA 
AGGGGGGGCTG: GGGGGGGCTGG 
AGGGTCAGTAC: GGGTCAGTACT 
AGGGTGAAAGG: GGGTGAAAGGA 
AGGGTGACCTC: GGGTGACCTCG 
AGGGTGCATTT: GGGTGCATTTC 
AGGGTTCTCAG: GGGTTCTCAGC 
AGGGTTTGTAG: GGGTTTGTAGG 
AGGTAATTATA: GGTAATTATAT 
AGGTATACACC: GGTATACACCC 
AGGTCCAATTG: GGTCCAATTGA 
AGGTCCATCCG: GGTCCATCCGA 
AGGTCGGCTTC: GGTCGGCTTCT 
AGGTCTAGCTA: GGTCTAGCTAT 
AGGTGAATTAA: GGTGAATTAAT 
AGGTGTACTAA: GGTGTACTAAC 
AGGTGTATTCT: GGTGTATTCTG 
AGGTGTTGCCC: GGTGTTGCCCT 
AGGTTACTGGA: GGTTACTGGAC 
AGGTTCTGGAT: GGTTCTGGATC 
AGTAAGTCGTA: GTAAGTCGTAC 
AGTACCTTAGC: GTACCTTAGCT 
AGTACGCGTCC: GTACGCGTCCG 
AGTACTGGTTT: GTACTGGTTTC 
AGTAGGATAAG: GTAGGATAAGG 
AGTAGGTCCAT: GTAGGTCCATC 
AGTAGTATTAG: GTAGTATTAGG 
AGTATCGTGGA: GTATCGTGGAT 
AGTATTAGGAC: GTATTAGGACG 
AGTATTTTCCT: GTATTTTCCTG 
AGTCCTGGATG: GTCCTGGATGG 
AGTCGAGCCAA: GTCGAGCCAAG 
AGTCGCAGTAG: GTCGCAGTAGG 
AGTCGCCAGTA: GTCGCCAGTAG 
AGTCGGCACGT: GTCGGCACGTT 
AGTCGTACCTC: GTCGTACCTCG 
AGTCTCTTACA: GTCTCTTACAG 
AGTGAAGCCGT: GTGAAGCCGTA 
AGTGAAGGGTC: GTGAAGGGTCA 
AGTGATAGACC: GTGATAGACCT 
AGTGATGGAAT: GTGATGGAATA 
AGTGCACTCCT: GTGCACTCCTT 
AGTGCCATTAC: GTGCCATTACG 
AGTGGACGATC: GTGGACGATCC 
AGTGGTTACCT: GTGGTTACCTA 
AGTGTGCACAA: GTGTGCACAAT 
AGTGTTCAACT: GTGTTCAACTA 
AGTGTTCGATT: GTGTTCGATTA 
AGTTACCGCGG: GTTACCGCGGG 
AGTTCTACATA: GTTCTACATAA 
AGTTCTCCCAC: GTTCTCCCACA 
AGTTGCCATGT: GTTGCCATGTA 
AGTTTAGCCCC: GTTTAGCCCCG 
AGTTTGCCAAA: GTTTGCCAAAT 
AGTTTTCAGGC: GTTTTCAGGCG 
ATAAAGAAGGA: TAAAGAAGGAG 
ATAAATTGATG: TAAATTGATGG 
ATAACAACGTC: TAACAACGTCA 
ATAACCTAGCT: TAACCTAGCTC 
ATAAGGGGGGG: TAAGGGGGGGC 
ATAATGTTGCA: TAATGTTGCAC 
ATAATTGCACA: TAATTGCACAT 
ATACACCCAGT: TACACCCAGTC 
ATACCAATACT: TACCAATACTA 
ATACCGTCCGG: TACCGTCCGGT 
ATACCTGAGGG: TACCTGAGGGT 
ATACGAACGAC: TACGAACGACC 
ATACGACATCA: TACGACATCAT 
ATACGAGCACA: TACGAGCACAG 
ATACGTATCGG: TACGTATCGGG 
ATACTAACCGC: TACTAACCGCT 
ATACTAATGAG: TACTAATGAGG 
ATAGACCTTGT: TAGACCTTGTT 
ATAGAGTGATA: TAGAGTGATAG 
ATAGGAATCCA: TAGGAATCCAA 
ATAGGATCCTT: TAGGATCCTTA 
ATAGGGAGGGG: TAGGGAGGGGG 
ATAGGGTGCAT: TAGGGTGCATT 
ATAGTGGTTAC: TAGTGGTTACC 
ATAGTGTGCAC: TAGTGTGCACA 
ATATACCAATA: TATACCAATAC 
ATATTAATCGC: TATTAATCGCG 
ATATTATAAAG: TATTATAAAGA 
ATATTCCGTAG: TATTCCGTAGG 
ATATTGTACGA: TATTGTACGAA 
ATCAACTGTAG: TCAACTGTAGT 
ATCACAAATTC: TCACAAATTCA 
ATCAGAAGACC: TCAGAAGACCC 
ATCAGACGATA: TCAGACGATAC 
ATCATACGTAT: TCATACGTATC 
ATCATAGTGGT: TCATAGTGGTT 
ATCATGCTACG: TCATGCTACGC 
ATCCAAATCAC: TCCAAATCACA 
ATCCAAGAGCA: TCCAAGAGCAT 
ATCCATCGACT: TCCATCGACTA 
ATCCCAGAGTG: TCCCAGAGTGG 
ATCCCGTGGAC: TCCCGTGGACG 
ATCCCTATTCC: TCCCTATTCCT 
ATCCGATCGGC: TCCGATCGGCG 
ATCCTGAACCA: TCCTGAACCAA 
ATCCTTACGCG: TCCTTACGCGT 
ATCGAAAATGC: TCGAAAATGCA 
ATCGACTAGAA: TCGACTAGAAC 
ATCGCACCCTC: TCGCACCCTCG 
ATCGCGAACGA: TCGCGAACGAT 
ATCGGCGAAGT: TCGGCGAAGTA 
ATCGGGTCTGT: TCGGGTCTGTT 
ATCGTACGCGC: TCGTACGCGCC 
ATCGTGGATCG: TCGTGGATCGC 
ATCGTTTCCAA: TCGTTTCCAAG 
ATCTCTGATGA: TCTCTGATGAT 
ATCTGGGAGAA: TCTGGGAGAAA 
ATCTTTCATGA: TCTTTCATGAA 
ATGAAGCGGTG: TGAAGCGGTGC 
ATGAATTCTTG: TGAATTCTTGG 
ATGAGGGTTTG: TGAGGGTTTGT 
ATGAGTACGCG: TGAGTACGCGT 
ATGATCAGACG: TGATCAGACGA 
ATGCAAGAACC: TGCAAGAACCC 
ATGCAAGCCCC: TGCAAGCCCCC 
ATGCACTATTA: TGCACTATTAT 
ATGCACTTAGT: TGCACTTAGTC 
ATGCAGGTCGG: TGCAGGTCGGC 
ATGCTACGCGC: TGCTACGCGCC 
ATGGAATACGA: TGGAATACGAA 
ATGGAATCTTT: TGGAATCTTTC 
ATGGATAGGGT: TGGATAGGGTG 
ATGGCATTGCA: TGGCATTGCAT 
ATGGCGCTATA: TGGCGCTATAT 
ATGGGTTAAAT: TGGGTTAAATG 
ATGGTAGCTTC: TGGTAGCTTCT 
ATGGTAGCTTG: TGGTAGCTTGT 
ATGTACGGGTT: TGTACGGGTTC 
ATGTCCGGCCC: TGTCCGGCCCG 
ATGTCTACACT: TGTCTACACTG 
ATGTCTTGAGT: TGTCTTGAGTT 
ATGTGGGAAGT: TGTGGGAAGTC 
ATGTGGGGGGT: TGTGGGGGGTT 
ATGTGTTCAGG: TGTGTTCAGGC 
ATGTTGCACGG: TGTTGCACGGT 
ATTAATCGCGA: TTAATCGCGAA 
ATTAATTTATT: TTAATTTATTA 
ATTACGCACTT: TTACGCACTTG 
ATTACGCTTAC: TTACGCTTACG 
ATTAGGACGTT: TTAGGACGTTA 
ATTAGGTCCAA: TTAGGTCCAAT 
ATTAGGTGTTG: TTAGGTGTTGC 
ATTAGTTACCG: TTAGTTACCGC 
ATTATAAAGAA: TTATAAAGAAG 
ATTATAATTGC: TTATAATTGCA 
ATTATATTCCG: TTATATTCCGT 
ATTATGAGTAC: TTATGAGTACG 
ATTATGCACTA: TTATGCACTAT 
ATTCACGCGTA: TTCACGCGTAT 
ATTCCCGGCAC: TTCCCGGCACA 
ATTCCGTAGGA: TTCCGTAGGAG 
ATTCCTTCCAA: TTCCTTCCAAC 
ATTCGCGGATG: TTCGCGGATGT 
ATTCTCTTGCT: TTCTCTTGCTC 
ATTCTGCCTCC: TTCTGCCTCCT 
ATTCTTGGAGT: TTCTTGGAGTC 
ATTGAACATTT: TTGAACATTTG 
ATTGAGGTGTA: TTGAGGTGTAC 
ATTGATGGCGC: TTGATGGCGCT 
ATTGATTGAAC: TTGATTGAACA 
ATTGCACATGT: TTGCACATGTG 
ATTGCATGAAT: TTGCATGAATT 
ATTGGTCTGAG: TTGGTCTGAGC 
ATTGTACGAAG: TTGTACGAAGG 
ATTGTGCATAG: TTGTGCATAGT 
ATTTACATTGG: TTTACATTGGT 
ATTTACCCTTT: TTTACCCTTTT 
ATTTATTATAA: TTTATTATAAT 
ATTTCATCATA: TTTCATCATAG 
ATTTCGCGAGC: TTTCGCGAGCG 
ATTTCGGGAAT: TTTCGGGAATA 
ATTTGAACTTT: TTTGAACTTTG 
ATTTTCCTGCA: TTTTCCTGCAA 
ATTTTCGGAAC: TTTTCGGAACG 
CAAAACTTCTT: AAAACTTCTTT 
CAAACGCGTCC: AAACGCGTCCG 
CAAATCACAAA: AAATCACAAAT 
CAAATCAGAAG: AAATCAGAAGA 
CAAATTCACGC: AAATTCACGCG 
CAACACTAATT: AACACTAATTC 
CAACAGTACCT: AACAGTACCTT 
CAACGTCAGCC: AACGTCAGCCC 
CAACGTGCCTC: AACGTGCCTCT 
CAACTAAGCTT: AACTAAGCTTT 
CAACTGCTGTC: AACTGCTGTCA 
CAACTGTAGTG: AACTGTAGTGC 
CAAGAACCCAC: AAGAACCCACA 
CAAGAGCATTT: AAGAGCATTTA 
CAAGATATACC: AAGATATACCA 
CAAGCCCCCAG: AAGCCCCCAGG 
CAAGCCGATAC: AAGCCGATACC 
CAAGCTGATCT: AAGCTGATCTG 
CAAGGGGAGTA: AAGGGGAGTAT 
CAAGTGATGGA: AAGTGATGGAA 
CAAGTTCTCCC: AAGTTCTCCCA 
CAAGTTTTCAG: AAGTTTTCAGG 
CAATACGAGCA: AATACGAGCAC 
CAATACTAATG: AATACTAATGA 
CAATCCCTATT: AATCCCTATTC 
CAATCCTGAAC: AATCCTGAACC 
CAATCTCTGAT: AATCTCTGATG 
CAATGGGTTAA: AATGGGTTAAA 
CAATGGTAGCT: AATGGTAGCTT 
CAATTGATTGA: AATTGATTGAA 
CACAAATTCAC: ACAAATTCACG 
CACAAGATATA: ACAAGATATAC 
CACAATCTCTG: ACAATCTCTGA 
CACACCTGTGT: ACACCTGTGTA 
CACAGGGACCC: ACAGGGACCCC 
CACAGGGGAGC: ACAGGGGAGCA 
CACAGTTCTAC: ACAGTTCTACA 
CACATCCATCG: ACATCCATCGA 
CACATGTGTTC: ACATGTGTTCA 
CACATTCGCGG: ACATTCGCGGA 
CACCCAGTCGC: ACCCAGTCGCA 
CACCCTCGACA: ACCCTCGACAA 
CACCGTAATTA: ACCGTAATTAG 
CACCTGTGTAT: ACCTGTGTATT 
CACGAACTGCT: ACGAACTGCTA 
CACGCGTATGT: ACGCGTATGTC 
CACGGCGCGGG: ACGGCGCGGGA 
CACGGTGCTTA: ACGGTGCTTAG 
CACGTCCGTGA: ACGTCCGTGAC 
CACGTGTCAGT: ACGTGTCAGTG 
CACGTTATTAG: ACGTTATTAGG 
CACTAATTCTC: ACTAATTCTCT 
CACTATTATGA: ACTATTATGAG 
CACTCCTTGCC: ACTCCTTGCCA 
CACTGCGTTAT: ACTGCGTTATC 
CACTGGGGAAT: ACTGGGGAATT 
CACTTAGTCGA: ACTTAGTCGAG 
CACTTGTTTTG: ACTTGTTTTGG 
CAGAAGACCCG: AGAAGACCCGC 
CAGACGATACT: AGACGATACTA 
CAGAGTGGACG: AGAGTGGACGA 
CAGATATTGTA: AGATATTGTAC 
CAGATTTCATC: AGATTTCATCA 
CAGCAATCCTG: AGCAATCCTGA 
CAGCCCATCAA: AGCCCATCAAC 
CAGCCCCGAAG: AGCCCCGAAGC 
CAGCCTCGGCG: AGCCTCGGCGC 
CAGCTTACGGA: AGCTTACGGAA 
CAGGAAACAAT: AGGAAACAATG 
CAGGAAACCTC: AGGAAACCTCT 
CAGGCGACCAG: AGGCGACCAGT 
CAGGCGCTTTA: AGGCGCTTTAA 
CAGGGACCCCA: AGGGACCCCAC 
CAGGGCACACC: AGGGCACACCT 
CAGGGGAGCAC: AGGGGAGCACA 
CAGGGTTCTCA: AGGGTTCTCAG 
CAGGTCGGCTT: AGGTCGGCTTC 
CAGGTTACTGG: AGGTTACTGGA 
CAGTAAGTCGT: AGTAAGTCGTA 
CAGTACCTTAG: AGTACCTTAGC 
CAGTACTGGTT: AGTACTGGTTT 
CAGTAGGATAA: AGTAGGATAAG 
CAGTAGGTCCA: AGTAGGTCCAT 
CAGTAGTATTA: AGTAGTATTAG 
CAGTCGCAGTA: AGTCGCAGTAG 
CAGTGCACTCC: AGTGCACTCCT 
CAGTGTTCAAC: AGTGTTCAACT 
CAGTGTTCGAT: AGTGTTCGATT 
CAGTTCTACAT: AGTTCTACATA 
CATAACCTAGC: ATAACCTAGCT 
CATACGTATCG: ATACGTATCGG 
CATAGGATCCT: ATAGGATCCTT 
CATAGGGAGGG: ATAGGGAGGGG 
CATAGTGGTTA: ATAGTGGTTAC 
CATAGTGTGCA: ATAGTGTGCAC 
CATCAACTGTA: ATCAACTGTAG 
CATCATACGTA: ATCATACGTAT 
CATCATAGTGG: ATCATAGTGGT 
CATCCATCGAC: ATCCATCGACT 
CATCCGATCGG: ATCCGATCGGC 
CATCGACTAGA: ATCGACTAGAA 
CATCGTTTCCA: ATCGTTTCCAA 
CATGAAGCGGT: ATGAAGCGGTG 
CATGAATTCTT: ATGAATTCTTG 
CATGCTACGCG: ATGCTACGCGC 
CATGGATAGGG: ATGGATAGGGT 
CATGTACGGGT: ATGTACGGGTT 
CATGTCTACAC: ATGTCTACACT 
CATGTGGGGGG: ATGTGGGGGGT 
CATGTGTTCAG: ATGTGTTCAGG 
CATTACGCTTA: ATTACGCTTAC 
CATTCGCGGAT: ATTCGCGGATG 
CATTGCATGAA: ATTGCATGAAT 
CATTGGTCTGA: ATTGGTCTGAG 
CATTTACCCTT: ATTTACCCTTT 
CATTTCGCGAG: ATTTCGCGAGC 
CATTTGAACTT: ATTTGAACTTT 
CCAAAACTTCT: CAAAACTTCTT 
CCAAATCACAA: CAAATCACAAA 
CCAAATCAGAA: CAAATCAGAAG 
CCAACACTAAT: CAACACTAATT 
CCAACAGTACC: CAACAGTACCT 
CCAACTGCTGT: CAACTGCTGTC 
CCAAGAGCATT: CAAGAGCATTT 
CCAAGGGGAGT: CAAGGGGAGTA 
CCAAGTTCTCC: CAAGTTCTCCC 
CCAATACTAAT: CAATACTAATG 
CCAATCCCTAT: CAATCCCTATT 
CCAATTGATTG: CAATTGATTGA 
CCACATCCATC: CACATCCATCG 
CCACATTCGCG: CACATTCGCGG 
CCACGAACTGC: CACGAACTGCT 
CCACGTCCGTG: CACGTCCGTGA 
CCACGTGTCAG: CACGTGTCAGT 
CCAGAGTGGAC: CAGAGTGGACG 
CCAGATTTCAT: CAGATTTCATC 
CCAGCAATCCT: CAGCAATCCTG 
CCAGGAAACCT: CAGGAAACCTC 
CCAGGGTTCTC: CAGGGTTCTCA 
CCAGGTTACTG: CAGGTTACTGG 
CCAGTAAGTCG: CAGTAAGTCGT 
CCAGTAGGTCC: CAGTAGGTCCA 
CCAGTCGCAGT: CAGTCGCAGTA 
CCAGTGTTCAA: CAGTGTTCAAC 
CCAGTGTTCGA: CAGTGTTCGAT 
CCATCAACTGT: CATCAACTGTA 
CCATCCGATCG: CATCCGATCGG 
CCATCGACTAG: CATCGACTAGA 
CCATGGATAGG: CATGGATAGGG 
CCATGTACGGG: CATGTACGGGT 
CCATTACGCTT: CATTACGCTTA 
CCCACATCCAT: CCACATCCATC 
CCCACATTCGC: CCACATTCGCG 
CCCACGAACTG: CCACGAACTGC 
CCCAGAGTGGA: CCAGAGTGGAC 
CCCAGGAAACC: CCAGGAAACCT 
CCCAGGGTTCT: CCAGGGTTCTC 
CCCAGGTTACT: CCAGGTTACTG 
CCCAGTAAGTC: CCAGTAAGTCG 
CCCAGTCGCAG: CCAGTCGCAGT 
CCCAGTGTTCA: CCAGTGTTCAA 
CCCATCAACTG: CCATCAACTGT 
CCCCACGAACT: CCCACGAACTG 
CCCCAGGAAAC: CCCAGGAAACC 
CCCCAGGGTTC: CCCAGGGTTCT 
CCCCAGTAAGT: CCCAGTAAGTC 
CCCCCAGGGTT: CCCCAGGGTTC 
CCCCGAAGAGG: CCCGAAGAGGT 
CCCCGAAGCTA: CCCGAAGCTAA 
CCCGAAGAGGT: CCGAAGAGGTT 
CCCGAAGCTAA: CCGAAGCTAAA 
CCCGAGCCTAG: CCGAGCCTAGC 
CCCGCCTGGAC: CCGCCTGGACC 
CCCGGCACAAG: CCGGCACAAGA 
CCCGTGGACGA: CCGTGGACGAG 
CCCGTGTCGAT: CCGTGTCGATA 
CCCTATTCCTT: CCTATTCCTTC 
CCCTCCCCAGT: CCTCCCCAGTA 
CCCTCGACAAA: CCTCGACAAAC 
CCCTCGTATAG: CCTCGTATAGG 
CCCTTATCGTA: CCTTATCGTAC 
CCCTTCGCATC: CCTTCGCATCG 
CCCTTTTCTAT: CCTTTTCTATA 
CCGAAGAGGTT: CGAAGAGGTTC 
CCGAAGCCCGA: CGAAGCCCGAG 
CCGAAGCTAAA: CGAAGCTAAAC 
CCGAATTAGGT: CGAATTAGGTG 
CCGAGAGTTTA: CGAGAGTTTAG 
CCGAGCCTAGC: CGAGCCTAGCG 
CCGATACCGTC: CGATACCGTCC 
CCGATCGGCGA: CGATCGGCGAA 
CCGCACCGTAA: CGCACCGTAAT 
CCGCCAACAGT: CGCCAACAGTA 
CCGCCTGGACC: CGCCTGGACCA 
CCGCGGGACGA: CGCGGGACGAT 
CCGGCACAAGA: CGGCACAAGAT 
CCGGCCCGTGT: CGGCCCGTGTC 
CCGGGTGAGGT: CGGGTGAGGTA 
CCGGTCCCAGT: CGGTCCCAGTG 
CCGGTCCCTTC: CGGTCCCTTCG 
CCGGTGTCCGA: CGGTGTCCGAA 
CCGTAATTAGT: CGTAATTAGTT 
CCGTAGACAGG: CGTAGACAGGA 
CCGTAGGAGTC: CGTAGGAGTCC 
CCGTCCGGTCC: CGTCCGGTCCC 
CCGTGACGATA: CGTGACGATAC 
CCGTGGACGAG: CGTGGACGAGG 
CCGTGTCGATA: CGTGTCGATAA 
CCTAATGCAGG: CTAATGCAGGT 
CCTACCGAATT: CTACCGAATTA 
CCTAGCGTCGG: CTAGCGTCGGT 
CCTAGCTCAGC: CTAGCTCAGCC 
CCTATTCCTTC: CTATTCCTTCC 
CCTCACGGCGC: CTCACGGCGCG 
CCTCCCCAGTA: CTCCCCAGTAA 
CCTCCTTTTAC: CTCCTTTTACC 
CCTCGACAAAC: CTCGACAAACG 
CCTCGGCGCGC: CTCGGCGCGCA 
CCTCGTAATAC: CTCGTAATACC 
CCTCGTATAGG: CTCGTATAGGA 
CCTCGTGGGCA: CTCGTGGGCAG 
CCTCTAGTGAA: CTCTAGTGAAG 
CCTCTCCTGGA: CTCTCCTGGAC 
CCTGAACCAAA: CTGAACCAAAA 
CCTGAGGGTGA: CTGAGGGTGAA 
CCTGCAATACG: CTGCAATACGA 
CCTGCGTGCGT: CTGCGTGCGTT 
CCTGGACCAAT: CTGGACCAATC 
CCTGGACCACG: CTGGACCACGT 
CCTGGATGGCA: CTGGATGGCAT 
CCTGTGTATTT: CTGTGTATTTC 
CCTTACGCGTA: CTTACGCGTAA 
CCTTAGCTTGT: CTTAGCTTGTA 
CCTTATCGTAC: CTTATCGTACG 
CCTTCCAACTG: CTTCCAACTGC 
CCTTCGCATCG: CTTCGCATCGT 
CCTTCGCTGAT: CTTCGCTGATA 
CCTTCTCCAAC: CTTCTCCAACA 
CCTTGCCATGG: CTTGCCATGGA 
CCTTGGGTGAA: CTTGGGTGAAG 
CCTTGTTGGGT: CTTGTTGGGTC 
CCTTTTACCGG: CTTTTACCGGT 
CCTTTTCTATA: CTTTTCTATAG 
CGAAAATGCAA: GAAAATGCAAG 
CGAACGACCAG: GAACGACCAGA 
CGAACGATGCA: GAACGATGCAA 
CGAACTGCTAC: GAACTGCTACG 
CGAAGAGGTTC: GAAGAGGTTCT 
CGAAGCCCGAG: GAAGCCCGAGC 
CGAAGCTAAAC: GAAGCTAAACA 
CGAAGGTCTAG: GAAGGTCTAGC 
CGAAGGTGAAT: GAAGGTGAATT 
CGAAGTATCGT: GAAGTATCGTG 
CGAATTAGGTG: GAATTAGGTGT 
CGACAAACGCG: GACAAACGCGT 
CGACAACGTGC: GACAACGTGCC 
CGACATCATAC: GACATCATACG 
CGACCAGATTT: GACCAGATTTC 
CGACCAGTGTT: GACCAGTGTTC 
CGACGTACCGC: GACGTACCGCC 
CGACTAGAACG: GACTAGAACGG 
CGAGAGTTTAG: GAGAGTTTAGC 
CGAGCACAGTT: GAGCACAGTTC 
CGAGCCAAGTT: GAGCCAAGTTC 
CGAGCCTAGCG: GAGCCTAGCGT 
CGAGCGTTTGT: GAGCGTTTGTC 
CGAGGACCTTC: GAGGACCTTCG 
CGATAAATTGA: GATAAATTGAT 
CGATACCGTCC: GATACCGTCCG 
CGATACGACAT: GATACGACATC 
CGATACTAACC: GATACTAACCG 
CGATCCCGTGG: GATCCCGTGGA 
CGATCGGCGAA: GATCGGCGAAG 
CGATGCAAGCC: GATGCAAGCCC 
CGATTACGCAC: GATTACGCACT 
CGATTATGCAC: GATTATGCACT 
CGCAAGTGATG: GCAAGTGATGG 
CGCACCCTCGA: GCACCCTCGAC 
CGCACCGTAAT: GCACCGTAATT 
CGCACTTGTTT: GCACTTGTTTT 
CGCAGCTTACG: GCAGCTTACGG 
CGCAGTAGGAT: GCAGTAGGATA 
CGCATCGTTTC: GCATCGTTTCC 
CGCCAACAGTA: GCCAACAGTAC 
CGCCACGTGTC: GCCACGTGTCA 
CGCCAGTAGGT: GCCAGTAGGTC 
CGCCCTTATCG: GCCCTTATCGT 
CGCCTACCGAA: GCCTACCGAAT 
CGCCTGGACCA: GCCTGGACCAA 
CGCGAACGATG: GCGAACGATGC 
CGCGACAACGT: GCGACAACGTG 
CGCGAGCGTTT: GCGAGCGTTTG 
CGCGCAGCTTA: GCGCAGCTTAC 
CGCGCCACGTG: GCGCCACGTGT 
CGCGCCTACCG: GCGCCTACCGA 
CGCGGATGTCT: GCGGATGTCTT 
CGCGGGACGAT: GCGGGACGATT 
CGCGGGATTGT: GCGGGATTGTG 
CGCGTAACCCC: GCGTAACCCCA 
CGCGTAAGAGG: GCGTAAGAGGG 
CGCGTATGTCC: GCGTATGTCCG 
CGCGTCCGGGT: GCGTCCGGGTG 
CGCGTCCGGTC: GCGTCCGGTCC 
CGCTATATTAT: GCTATATTATA 
CGCTGATATTA: GCTGATATTAA 
CGCTTACGTTC: GCTTACGTTCC 
CGCTTTAAAAG: GCTTTAAAAGG 
CGGAAAGGCGA: GGAAAGGCGAA 
CGGAACGACGT: GGAACGACGTA 
CGGATGTCTTG: GGATGTCTTGA 
CGGCACAAGAT: GGCACAAGATA 
CGGCACGTTAT: GGCACGTTATT 
CGGCCCGTGTC: GGCCCGTGTCG 
CGGCGAAGTAT: GGCGAAGTATC 
CGGCGCGCAGC: GGCGCGCAGCT 
CGGCGCGGGAT: GGCGCGGGATT 
CGGCTTCTGTT: GGCTTCTGTTG 
CGGGAATAACA: GGGAATAACAA 
CGGGACGATTA: GGGACGATTAC 
CGGGATTGTGC: GGGATTGTGCA 
CGGGTCTGTTT: GGGTCTGTTTT 
CGGGTGAGGTA: GGGTGAGGTAT 
CGGGTTCTTGT: GGGTTCTTGTC 
CGGTCCCAGTG: GGTCCCAGTGT 
CGGTCCCTTCG: GGTCCCTTCGC 
CGGTCGTCAAG: GGTCGTCAAGC 
CGGTGCATAGG: GGTGCATAGGG 
CGGTGCTTAGA: GGTGCTTAGAA 
CGGTGGGCAGA: GGTGGGCAGAT 
CGGTGTCCGAA: GGTGTCCGAAG 
CGTAACCCCAG: GTAACCCCAGG 
CGTAAGAGGGA: GTAAGAGGGAG 
CGTAATACCTG: GTAATACCTGA 
CGTAATTAGTT: GTAATTAGTTA 
CGTACCGCCAA: GTACCGCCAAC 
CGTACCTCGTA: GTACCTCGTAA 
CGTACGCGCCT: GTACGCGCCTA 
CGTAGACAGGA: GTAGACAGGAA 
CGTAGGAGTCC: GTAGGAGTCCT 
CGTATAGGAAT: GTATAGGAATC 
CGTATCGGGTC: GTATCGGGTCT 
CGTATGTCCGG: GTATGTCCGGC 
CGTATTCCCGG: GTATTCCCGGC 
CGTCAAGCCGA: GTCAAGCCGAT 
CGTCAGCCCCG: GTCAGCCCCGA 
CGTCCGGGTGA: GTCCGGGTGAG 
CGTCCGGTCCC: GTCCGGTCCCA GTCCGGTCCCT 
CGTCCGTGACG: GTCCGTGACGA 
CGTCGGTCGTC: GTCGGTCGTCA 
CGTGACGATAC: GTGACGATACG 
CGTGCCTCTCC: GTGCCTCTCCT 
CGTGCGTTTCC: GTGCGTTTCCC 
CGTGGACGAGG: GTGGACGAGGA 
CGTGGATCGCA: GTGGATCGCAC 
CGTGGGCAGTA: GTGGGCAGTAG 
CGTGTCAGTGC: GTGTCAGTGCA 
CGTGTCGATAA: GTGTCGATAAA 
CGTTAGAGAAA: GTTAGAGAAAA 
CGTTATCATGC: GTTATCATGCT 
CGTTATTAGGT: GTTATTAGGTC 
CGTTCCGAGAG: GTTCCGAGAGT 
CGTTTCCAAGG: GTTTCCAAGGG 
CGTTTCCCAGG: GTTTCCCAGGT 
CGTTTGTCTGC: GTTTGTCTGCC 
CTAAACATAGG: TAAACATAGGA 
CTAACCGCTTA: TAACCGCTTAA 
CTAACGTATTC: TAACGTATTCC 
CTAAGCTTTGA: TAAGCTTTGAC 
CTAATGAGGGT: TAATGAGGGTT 
CTAATGCAGGT: TAATGCAGGTC 
CTAATTCTCTT: TAATTCTCTTG 
CTACACTGCGT: TACACTGCGTT 
CTACATAACCT: TACATAACCTA 
CTACATGTGGG: TACATGTGGGG 
CTACCGAATTA: TACCGAATTAG 
CTACGCGCCAC: TACGCGCCACG 
CTACGCGTAAG: TACGCGTAAGA 
CTAGAACGGTG: TAGAACGGTGG 
CTAGCGTCGGT: TAGCGTCGGTC 
CTAGCTATGGT: TAGCTATGGTA 
CTAGCTCAGCC: TAGCTCAGCCC 
CTAGTGAAGGG: TAGTGAAGGGT 
CTATAGAGTGA: TATAGAGTGAT 
CTATATTATAA: TATATTATAAA 
CTATGGTAGCT: TATGGTAGCTT 
CTATTATGAGT: TATTATGAGTA 
CTATTCCTTCC: TATTCCTTCCA 
CTCACAGGGGA: TCACAGGGGAG 
CTCACGGCGCG: TCACGGCGCGG 
CTCAGCCCATC: TCAGCCCATCA 
CTCAGCCTCGG: TCAGCCTCGGC 
CTCATGTCTAC: TCATGTCTACA 
CTCCAACACTA: TCCAACACTAA 
CTCCCACATTC: TCCCACATTCG 
CTCCCCAGTAA: TCCCCAGTAAG 
CTCCTGGACCA: TCCTGGACCAC 
CTCCTTCTCCA: TCCTTCTCCAA 
CTCCTTGCCAT: TCCTTGCCATG 
CTCCTTTTACC: TCCTTTTACCG 
CTCGACAAACG: TCGACAAACGC 
CTCGGCGCGCA: TCGGCGCGCAG 
CTCGTAATACC: TCGTAATACCT 
CTCGTATAGGA: TCGTATAGGAA 
CTCGTGGGCAG: TCGTGGGCAGT 
CTCTACATGTG: TCTACATGTGG 
CTCTAGTGAAG: TCTAGTGAAGG 
CTCTCCTGGAC: TCTCCTGGACC 
CTCTGATGATC: TCTGATGATCA 
CTCTTACAGGG: TCTTACAGGGC 
CTCTTGCTCAC: TCTTGCTCACA 
CTGAACCAAAA: TGAACCAAAAC 
CTGAGCGCAAG: TGAGCGCAAGT 
CTGAGGGTGAA: TGAGGGTGAAA 
CTGATATTAAT: TGATATTAATC 
CTGATCTGGGA: TGATCTGGGAG 
CTGATGATCAG: TGATGATCAGA 
CTGATTGAGGT: TGATTGAGGTG 
CTGCAATACGA: TGCAATACGAG 
CTGCCGCACCG: TGCCGCACCGT 
CTGCCTCCTTT: TGCCTCCTTTT 
CTGCGTGCGTT: TGCGTGCGTTT 
CTGCGTTATCA: TGCGTTATCAT 
CTGCTACGCGT: TGCTACGCGTA 
CTGCTGTCACT: TGCTGTCACTG 
CTGGACCAATC: TGGACCAATCC 
CTGGACCACGT: TGGACCACGTC 
CTGGACTGGAG: TGGACTGGAGT 
CTGGAGTGAAG: TGGAGTGAAGC 
CTGGATCCAAG: TGGATCCAAGA 
CTGGATGGCAT: TGGATGGCATT 
CTGGGAGAAAG: TGGGAGAAAGT 
CTGGGGAATTT: TGGGGAATTTT 
CTGGGGGACGC: TGGGGGACGCC 
CTGGTTTCCTG: TGGTTTCCTGC 
CTGTAGTGCCA: TGTAGTGCCAT 
CTGTCACTGGG: TGTCACTGGGG 
CTGTGTATTTC: TGTGTATTTCG 
CTGTTGGGGAG: TGTTGGGGAGC 
CTGTTTTTCCA: TGTTTTTCCAG 
CTTACAGGGCA: TTACAGGGCAC 
CTTACGCGTAA: TTACGCGTAAC 
CTTACGGAAAG: TTACGGAAAGG 
CTTACGTTCCG: TTACGTTCCGA 
CTTAGAAAATT: TTAGAAAATTT 
CTTAGCTTGTA: TTAGCTTGTAG 
CTTAGTCGAGC: TTAGTCGAGCC 
CTTATCGTACG: TTATCGTACGC 
CTTCCAACTGC: TTCCAACTGCT 
CTTCGCATCGT: TTCGCATCGTT 
CTTCGCTGATA: TTCGCTGATAT 
CTTCTCCAACA: TTCTCCAACAC 
CTTCTCCTTCT: TTCTCCTTCTC 
CTTCTGTTGGG: TTCTGTTGGGG 
CTTCTTTTCTC: TTCTTTTCTCT 
CTTGAGTTGCC: TTGAGTTGCCA 
CTTGCCATGGA: TTGCCATGGAT 
CTTGCTCACAG: TTGCTCACAGG 
CTTGGAGTCGC: TTGGAGTCGCC 
CTTGGGTGAAG: TTGGGTGAAGA 
CTTGTAGGTGT: TTGTAGGTGTA 
CTTGTCAAGTT: TTGTCAAGTTT 
CTTGTTCCTCA: TTGTTCCTCAC 
CTTGTTGGGTC: TTGTTGGGTCA 
CTTGTTTTGGG: TTGTTTTGGGG 
CTTTAAAAGGT: TTTAAAAGGTA 
CTTTCATGAAG: TTTCATGAAGC 
CTTTGAAAACG: TTTGAAAACGC 
CTTTGACTGAT: TTTGACTGATT 
CTTTTACCGGT: TTTTACCGGTG 
CTTTTCTATAG: TTTTCTATAGA 
CTTTTCTCTAC: TTTTCTCTACA 
GAAAAATGTGG: AAAAATGTGGG 
GAAAACGCGAC: AAAACGCGACA 
GAAAATGCAAG: AAAATGCAAGA 
GAAAATTTACA: AAAATTTACAT 
GAAACAATGGG: AAACAATGGGT 
GAAACCTCTAG: AAACCTCTAGT 
GAAAGGAAGGG: AAAGGAAGGGT 
GAAAGGCGAAG: AAAGGCGAAGG 
GAAAGTCTCTT: AAAGTCTCTTA 
GAACATTTGAA: AACATTTGAAC 
GAACCAAAACT: AACCAAAACTT 
GAACCCACATC: AACCCACATCC 
GAACGACCAGA: AACGACCAGAT 
GAACGACGTAC: AACGACGTACC 
GAACGATGCAA: AACGATGCAAG 
GAACGGTGGGC: AACGGTGGGCA 
GAACTGCTACG: AACTGCTACGC 
GAACTTTGAAA: AACTTTGAAAA 
GAAGACCCGCC: AAGACCCGCCT 
GAAGAGGATAA: AAGAGGATAAT 
GAAGAGGTTCT: AAGAGGTTCTG 
GAAGCCCGAGC: AAGCCCGAGCC 
GAAGCCGTAGA: AAGCCGTAGAC 
GAAGCGGTGCA: AAGCGGTGCAT 
GAAGCTAAACA: AAGCTAAACAT 
GAAGGAGCCTT: AAGGAGCCTTG 
GAAGGGTCAGT: AAGGGTCAGTA 
GAAGGGTGACC: AAGGGTGACCT 
GAAGGTCTAGC: AAGGTCTAGCT 
GAAGGTGAATT: AAGGTGAATTA 
GAAGTATCGTG: AAGTATCGTGG 
GAAGTCGGCAC: AAGTCGGCACG 
GAATAACAACG: AATAACAACGT 
GAATACGAACG: AATACGAACGA 
GAATCCAAATC: AATCCAAATCA 
GAATCTTTCAT: AATCTTTCATG 
GAATTAATTTA: AATTAATTTAT 
GAATTAGGTGT: AATTAGGTGTT 
GAATTCTTGGA: AATTCTTGGAG 
GAATTTTCGGA: AATTTTCGGAA 
GACAAACGCGT: ACAAACGCGTC 
GACAACGTGCC: ACAACGTGCCT 
GACAGGAAACA: ACAGGAAACAA 
GACATCATACG: ACATCATACGT 
GACCAATCCCT: ACCAATCCCTA 
GACCACGTCCG: ACCACGTCCGT 
GACCAGATTTC: ACCAGATTTCA 
GACCAGTGTTC: ACCAGTGTTCG 
GACCCCACGAA: ACCCCACGAAC 
GACCCGCCTGG: ACCCGCCTGGA 
GACCTCGTGGG: ACCTCGTGGGC 
GACCTTCGCTG: ACCTTCGCTGA 
GACCTTGTTGG: ACCTTGTTGGG 
GACGAGGACCT: ACGAGGACCTT 
GACGATACGAC: ACGATACGACA 
GACGATACTAA: ACGATACTAAC 
GACGATCCCGT: ACGATCCCGTG 
GACGATTACGC: ACGATTACGCA 
GACGCCCTTAT: ACGCCCTTATC 
GACGTACCGCC: ACGTACCGCCA 
GACGTTAGAGA: ACGTTAGAGAA 
GACTAGAACGG: ACTAGAACGGT 
GACTGATTGAG: ACTGATTGAGG 
GACTGGAGTGA: ACTGGAGTGAA 
GAGAAAAATGT: AGAAAAATGTG 
GAGAAAGTCTC: AGAAAGTCTCT 
GAGAGTTTAGC: AGAGTTTAGCC 
GAGCACAGGGA: AGCACAGGGAC 
GAGCACAGTTC: AGCACAGTTCT 
GAGCATTTACC: AGCATTTACCC 
GAGCCAAGTTC: AGCCAAGTTCT 
GAGCCCTCCCC: AGCCCTCCCCA 
GAGCCTAGCGT: AGCCTAGCGTC 
GAGCCTTGGGT: AGCCTTGGGTG 
GAGCGCAAGTG: AGCGCAAGTGA 
GAGCGTTTGTC: AGCGTTTGTCT 
GAGCTCATGTC: AGCTCATGTCT 
GAGGACCTTCG: AGGACCTTCGC 
GAGGATAATGT: AGGATAATGTT 
GAGGGAGCTCA: AGGGAGCTCAT 
GAGGGGGATCG: AGGGGGATCGA 
GAGGGTGAAAG: AGGGTGAAAGG 
GAGGGTTTGTA: AGGGTTTGTAG 
GAGGTATACAC: AGGTATACACC 
GAGGTGTACTA: AGGTGTACTAA 
GAGGTTCTGGA: AGGTTCTGGAT 
GAGTACGCGTC: AGTACGCGTCC 
GAGTATTTTCC: AGTATTTTCCT 
GAGTCCTGGAT: AGTCCTGGATG 
GAGTCGCCAGT: AGTCGCCAGTA 
GAGTGAAGCCG: AGTGAAGCCGT 
GAGTGATAGAC: AGTGATAGACC 
GAGTGGACGAT: AGTGGACGATC 
GAGTTGCCATG: AGTTGCCATGT 
GAGTTTAGCCC: AGTTTAGCCCC 
GAGTTTGCCAA: AGTTTGCCAAA 
GATAAATTGAT: ATAAATTGATG 
GATAAGGGGGG: ATAAGGGGGGG 
GATAATGTTGC: ATAATGTTGCA 
GATACCGTCCG: ATACCGTCCGG 
GATACGACATC: ATACGACATCA 
GATACTAACCG: ATACTAACCGC 
GATAGACCTTG: ATAGACCTTGT 
GATAGGGTGCA: ATAGGGTGCAT 
GATATACCAAT: ATATACCAATA 
GATATTAATCG: ATATTAATCGC 
GATATTGTACG: ATATTGTACGA 
GATCAGACGAT: ATCAGACGATA 
GATCCAAGAGC: ATCCAAGAGCA 
GATCCCGTGGA: ATCCCGTGGAC 
GATCCTTACGC: ATCCTTACGCG 
GATCGAAAATG: ATCGAAAATGC 
GATCGCACCCT: ATCGCACCCTC 
GATCGGCGAAG: ATCGGCGAAGT 
GATCTGGGAGA: ATCTGGGAGAA 
GATGATCAGAC: ATGATCAGACG 
GATGCAAGCCC: ATGCAAGCCCC 
GATGGAATACG: ATGGAATACGA 
GATGGCATTGC: ATGGCATTGCA 
GATGGCGCTAT: ATGGCGCTATA 
GATGTCTTGAG: ATGTCTTGAGT 
GATTACGCACT: ATTACGCACTT 
GATTATGCACT: ATTATGCACTA 
GATTGAACATT: ATTGAACATTT 
GATTGAGGTGT: ATTGAGGTGTA 
GATTGTGCATA: ATTGTGCATAG 
GATTTCATCAT: ATTTCATCATA 
GCAAGAACCCA: CAAGAACCCAC 
GCAAGCCCCCA: CAAGCCCCCAG 
GCAAGTGATGG: CAAGTGATGGA 
GCAATACGAGC: CAATACGAGCA 
GCAATCCTGAA: CAATCCTGAAC 
GCACAAGATAT: CACAAGATATA 
GCACAATCTCT: CACAATCTCTG 
GCACACCTGTG: CACACCTGTGT 
GCACAGGGACC: CACAGGGACCC 
GCACAGTTCTA: CACAGTTCTAC 
GCACATGTGTT: CACATGTGTTC 
GCACCCTCGAC: CACCCTCGACA 
GCACCGTAATT: CACCGTAATTA 
GCACGGTGCTT: CACGGTGCTTA 
GCACGTTATTA: CACGTTATTAG 
GCACTATTATG: CACTATTATGA 
GCACTCCTTGC: CACTCCTTGCC 
GCACTTAGTCG: CACTTAGTCGA 
GCACTTGTTTT: CACTTGTTTTG 
GCAGATATTGT: CAGATATTGTA 
GCAGCTTACGG: CAGCTTACGGA 
GCAGGTCGGCT: CAGGTCGGCTT 
GCAGTAGGATA: CAGTAGGATAA 
GCAGTAGTATT: CAGTAGTATTA 
GCATAGGGAGG: CATAGGGAGGG 
GCATAGTGTGC: CATAGTGTGCA 
GCATCGTTTCC: CATCGTTTCCA 
GCATGAATTCT: CATGAATTCTT 
GCATTGCATGA: CATTGCATGAA 
GCATTTACCCT: CATTTACCCTT 
GCATTTCGCGA: CATTTCGCGAG 
GCCAAATCAGA: CCAAATCAGAA 
GCCAACAGTAC: CCAACAGTACC 
GCCAAGTTCTC: CCAAGTTCTCC 
GCCACGTGTCA: CCACGTGTCAG 
GCCAGTAGGTC: CCAGTAGGTCC 
GCCATGGATAG: CCATGGATAGG 
GCCATGTACGG: CCATGTACGGG 
GCCATTACGCT: CCATTACGCTT 
GCCCATCAACT: CCCATCAACTG 
GCCCCCAGGGT: CCCCCAGGGTT 
GCCCCGAAGAG: CCCCGAAGAGG 
GCCCCGAAGCT: CCCCGAAGCTA 
GCCCGAGCCTA: CCCGAGCCTAG 
GCCCGTGTCGA: CCCGTGTCGAT 
GCCCTCCCCAG: CCCTCCCCAGT 
GCCCTCGTATA: CCCTCGTATAG 
GCCCTTATCGT: CCCTTATCGTA 
GCCGATACCGT: CCGATACCGTC 
GCCGCACCGTA: CCGCACCGTAA 
GCCGTAGACAG: CCGTAGACAGG 
GCCTACCGAAT: CCTACCGAATT 
GCCTAGCGTCG: CCTAGCGTCGG 
GCCTCCTTTTA: CCTCCTTTTAC 
GCCTCGGCGCG: CCTCGGCGCGC 
GCCTCTCCTGG: CCTCTCCTGGA 
GCCTGGACCAA: CCTGGACCAAT 
GCCTTGGGTGA: CCTTGGGTGAA 
GCGAACGATGC: CGAACGATGCA 
GCGAAGGTGAA: CGAAGGTGAAT 
GCGAAGTATCG: CGAAGTATCGT 
GCGACAACGTG: CGACAACGTGC 
GCGACCAGTGT: CGACCAGTGTT 
GCGAGCGTTTG: CGAGCGTTTGT 
GCGCAAGTGAT: CGCAAGTGATG 
GCGCAGCTTAC: CGCAGCTTACG 
GCGCCACGTGT: CGCCACGTGTC 
GCGCCTACCGA: CGCCTACCGAA 
GCGCGCAGCTT: CGCGCAGCTTA 
GCGCGGGATTG: CGCGGGATTGT 
GCGCTATATTA: CGCTATATTAT 
GCGCTTTAAAA: CGCTTTAAAAG 
GCGGATGTCTT: CGGATGTCTTG 
GCGGGACGATT: CGGGACGATTA 
GCGGGATTGTG: CGGGATTGTGC 
GCGGTGCATAG: CGGTGCATAGG 
GCGTAACCCCA: CGTAACCCCAG 
GCGTAAGAGGG: CGTAAGAGGGA 
GCGTATGTCCG: CGTATGTCCGG 
GCGTCCGGGTG: CGTCCGGGTGA 
GCGTCCGGTCC: CGTCCGGTCCC 
GCGTCGGTCGT: CGTCGGTCGTC 
GCGTGCGTTTC: CGTGCGTTTCC 
GCGTTATCATG: CGTTATCATGC 
GCGTTTCCCAG: CGTTTCCCAGG 
GCGTTTGTCTG: CGTTTGTCTGC 
GCTAAACATAG: CTAAACATAGG 
GCTACGCGCCA: CTACGCGCCAC 
GCTACGCGTAA: CTACGCGTAAG 
GCTATATTATA: CTATATTATAA 
GCTATGGTAGC: CTATGGTAGCT 
GCTCACAGGGG: CTCACAGGGGA 
GCTCAGCCCAT: CTCAGCCCATC 
GCTCATGTCTA: CTCATGTCTAC 
GCTGATATTAA: CTGATATTAAT 
GCTGATCTGGG: CTGATCTGGGA 
GCTGGGGGACG: CTGGGGGACGC 
GCTGTCACTGG: CTGTCACTGGG 
GCTTACGGAAA: CTTACGGAAAG 
GCTTACGTTCC: CTTACGTTCCG 
GCTTAGAAAAT: CTTAGAAAATT 
GCTTCTCCTTC: CTTCTCCTTCT 
GCTTCTGTTGG: CTTCTGTTGGG 
GCTTGTAGGTG: CTTGTAGGTGT 
GCTTGTTCCTC: CTTGTTCCTCA 
GCTTTAAAAGG: CTTTAAAAGGT 
GCTTTGACTGA: CTTTGACTGAT 
GGAAACAATGG: GAAACAATGGG 
GGAAACCTCTA: GAAACCTCTAG 
GGAAAGGCGAA: GAAAGGCGAAG 
GGAACGACGTA: GAACGACGTAC 
GGAAGGGTGAC: GAAGGGTGACC 
GGAAGTCGGCA: GAAGTCGGCAC 
GGAATAACAAC: GAATAACAACG 
GGAATACGAAC: GAATACGAACG 
GGAATCCAAAT: GAATCCAAATC 
GGAATCTTTCA: GAATCTTTCAT 
GGAATTTTCGG: GAATTTTCGGA 
GGACCAATCCC: GACCAATCCCT 
GGACCACGTCC: GACCACGTCCG 
GGACCCCACGA: GACCCCACGAA 
GGACCTTCGCT: GACCTTCGCTG 
GGACGAGGACC: GACGAGGACCT 
GGACGATCCCG: GACGATCCCGT 
GGACGATTACG: GACGATTACGC 
GGACGCCCTTA: GACGCCCTTAT 
GGACGTTAGAG: GACGTTAGAGA 
GGACTGGAGTG: GACTGGAGTGA 
GGAGAAAGTCT: GAGAAAGTCTC 
GGAGCACAGGG: GAGCACAGGGA 
GGAGCCCTCCC: GAGCCCTCCCC 
GGAGCCTTGGG: GAGCCTTGGGT 
GGAGCTCATGT: GAGCTCATGTC 
GGAGGGGGATC: GAGGGGGATCG 
GGAGTATTTTC: GAGTATTTTCC 
GGAGTCCTGGA: GAGTCCTGGAT 
GGAGTCGCCAG: GAGTCGCCAGT 
GGAGTGAAGCC: GAGTGAAGCCG 
GGAGTTTGCCA: GAGTTTGCCAA 
GGATAAGGGGG: GATAAGGGGGG 
GGATAATGTTG: GATAATGTTGC 
GGATAGGGTGC: GATAGGGTGCA 
GGATCCAAGAG: GATCCAAGAGC 
GGATCCTTACG: GATCCTTACGC 
GGATCGAAAAT: GATCGAAAATG 
GGATCGCACCC: GATCGCACCCT 
GGATGGCATTG: GATGGCATTGC 
GGATGTCTTGA: GATGTCTTGAG 
GGATTGTGCAT: GATTGTGCATA 
GGCACAAGATA: GCACAAGATAT 
GGCACACCTGT: GCACACCTGTG 
GGCACGTTATT: GCACGTTATTA 
GGCAGATATTG: GCAGATATTGT 
GGCAGTAGTAT: GCAGTAGTATT 
GGCATTGCATG: GCATTGCATGA 
GGCCCGTGTCG: GCCCGTGTCGA 
GGCGAAGGTGA: GCGAAGGTGAA 
GGCGAAGTATC: GCGAAGTATCG 
GGCGACCAGTG: GCGACCAGTGT 
GGCGCGCAGCT: GCGCGCAGCTT 
GGCGCGGGATT: GCGCGGGATTG 
GGCGCTATATT: GCGCTATATTA 
GGCGCTTTAAA: GCGCTTTAAAA 
GGCTGGGGGAC: GCTGGGGGACG 
GGCTTCTGTTG: GCTTCTGTTGG 
GGGAAGTCGGC: GGAAGTCGGCA 
GGGAATAACAA: GGAATAACAAC 
GGGAATTTTCG: GGAATTTTCGG 
GGGACCCCACG: GGACCCCACGA 
GGGACGATTAC: GGACGATTACG 
GGGACGCCCTT: GGACGCCCTTA 
GGGAGAAAGTC: GGAGAAAGTCT 
GGGAGCACAGG: GGAGCACAGGG 
GGGAGCCCTCC: GGAGCCCTCCC 
GGGAGCTCATG: GGAGCTCATGT 
GGGAGGGGGAT: GGAGGGGGATC 
GGGAGTATTTT: GGAGTATTTTC 
GGGATCGAAAA: GGATCGAAAAT 
GGGATTGTGCA: GGATTGTGCAT 
GGGCACACCTG: GGCACACCTGT 
GGGCAGATATT: GGCAGATATTG 
GGGCAGTAGTA: GGCAGTAGTAT 
GGGCTGGGGGA: GGCTGGGGGAC 
GGGGAATTTTC: GGGAATTTTCG 
GGGGACGCCCT: GGGACGCCCTT 
GGGGAGCACAG: GGGAGCACAGG 
GGGGAGCCCTC: GGGAGCCCTCC 
GGGGAGTATTT: GGGAGTATTTT 
GGGGATCGAAA: GGGATCGAAAA 
GGGGCTGGGGG: GGGCTGGGGGA 
GGGGGACGCCC: GGGGACGCCCT 
GGGGGATCGAA: GGGGATCGAAA 
GGGGGCTGGGG: GGGGCTGGGGG 
GGGGGGCTGGG: GGGGGCTGGGG 
GGGGGGGCTGG: GGGGGGCTGGG 
GGGGGGTTTAT: GGGGGTTTATC 
GGGGGTTTATC: GGGGTTTATCC 
GGGGTATGGAA: GGGTATGGAAT 
GGGGTTTATCC: GGGTTTATCCC 
GGGTATGGAAT: GGTATGGAATC 
GGGTCAATGGT: GGTCAATGGTA 
GGGTCAGTACT: GGTCAGTACTG 
GGGTCTGTTTT: GGTCTGTTTTT 
GGGTGAAAGGA: GGTGAAAGGAA 
GGGTGAAGAGG: GGTGAAGAGGA 
GGGTGACCTCG: GGTGACCTCGT 
GGGTGAGGTAT: GGTGAGGTATA 
GGGTGCATTTC: GGTGCATTTCG 
GGGTTAAATGC: GGTTAAATGCA 
GGGTTCTCAGC: GGTTCTCAGCC 
GGGTTCTTGTC: GGTTCTTGTCA 
GGGTTTATCCC: GGTTTATCCCA 
GGGTTTGTAGG: GGTTTGTAGGA 
GGTAATTATAT: GTAATTATATT 
GGTAGCTTCTC: GTAGCTTCTCC 
GGTAGCTTGTT: GTAGCTTGTTC 
GGTATACACCC: GTATACACCCA 
GGTATGGAATC: GTATGGAATCT 
GGTCAATGGTA: GTCAATGGTAG 
GGTCAGTACTG: GTCAGTACTGG 
GGTCCAATTGA: GTCCAATTGAT 
GGTCCATCCGA: GTCCATCCGAT 
GGTCCCAGTGT: GTCCCAGTGTT 
GGTCCCTTCGC: GTCCCTTCGCA 
GGTCGGCTTCT: GTCGGCTTCTG 
GGTCGTCAAGC: GTCGTCAAGCC 
GGTCTAGCTAT: GTCTAGCTATG 
GGTCTGAGCGC: GTCTGAGCGCA 
GGTCTGTTTTT: GTCTGTTTTTC 
GGTGAAAGGAA: GTGAAAGGAAG 
GGTGAAGAGGA: GTGAAGAGGAT 
GGTGAATTAAT: GTGAATTAATT 
GGTGACCTCGT: GTGACCTCGTG 
GGTGAGGTATA: GTGAGGTATAC 
GGTGCATAGGG: GTGCATAGGGA 
GGTGCATTTCG: GTGCATTTCGC 
GGTGCTTAGAA: GTGCTTAGAAA 
GGTGGGCAGAT: GTGGGCAGATA 
GGTGTACTAAC: GTGTACTAACG 
GGTGTATTCTG: GTGTATTCTGC 
GGTGTCCGAAG: GTGTCCGAAGC 
GGTGTTGCCCT: GTGTTGCCCTC 
GGTTAAATGCA: GTTAAATGCAC 
GGTTACCTAAT: GTTACCTAATG 
GGTTACTGGAC: GTTACTGGACT 
GGTTCTCAGCC: GTTCTCAGCCT 
GGTTCTGGATC: GTTCTGGATCC 
GGTTCTTGTCA: GTTCTTGTCAA 
GGTTTATCCCA: GTTTATCCCAG 
GGTTTCCTGCG: GTTTCCTGCGT 
GGTTTGTAGGA: GTTTGTAGGAG 
GTAACCCCAGG: TAACCCCAGGA 
GTAAGAGGGAG: TAAGAGGGAGC 
GTAAGTCGTAC: TAAGTCGTACC 
GTAATACCTGA: TAATACCTGAG 
GTAATTAGTTA: TAATTAGTTAC 
GTAATTATATT: TAATTATATTC 
GTACCGCCAAC: TACCGCCAACA 
GTACCTCGTAA: TACCTCGTAAT 
GTACCTTAGCT: TACCTTAGCTT 
GTACGAAGGTC: TACGAAGGTCT 
GTACGCGCCTA: TACGCGCCTAC 
GTACGCGTCCG: TACGCGTCCGG 
GTACGGGTTCT: TACGGGTTCTT 
GTACTAACGTA: TACTAACGTAT 
GTACTGGTTTC: TACTGGTTTCC 
GTAGACAGGAA: TAGACAGGAAA 
GTAGCTTCTCC: TAGCTTCTCCT 
GTAGCTTGTTC: TAGCTTGTTCC 
GTAGGAGTCCT: TAGGAGTCCTG 
GTAGGAGTTTG: TAGGAGTTTGC 
GTAGGATAAGG: TAGGATAAGGG 
GTAGGTCCATC: TAGGTCCATCC 
GTAGGTGTATT: TAGGTGTATTC 
GTAGTATTAGG: TAGTATTAGGA 
GTAGTGCCATT: TAGTGCCATTA 
GTATACACCCA: TATACACCCAG 
GTATAGGAATC: TATAGGAATCC 
GTATCGGGTCT: TATCGGGTCTG 
GTATCGTGGAT: TATCGTGGATC 
GTATGGAATCT: TATGGAATCTT 
GTATGTCCGGC: TATGTCCGGCC 
GTATTAGGACG: TATTAGGACGT 
GTATTCCCGGC: TATTCCCGGCA 
GTATTCTGCCT: TATTCTGCCTC 
GTATTTCGGGA: TATTTCGGGAA 
GTATTTTCCTG: TATTTTCCTGC 
GTCAAGCCGAT: TCAAGCCGATA 
GTCAAGTTTTC: TCAAGTTTTCA 
GTCAATGGTAG: TCAATGGTAGC 
GTCACTGGGGA: TCACTGGGGAA 
GTCAGCCCCGA: TCAGCCCCGAA 
GTCAGTACTGG: TCAGTACTGGT 
GTCAGTGCACT: TCAGTGCACTC 
GTCCAATTGAT: TCCAATTGATT 
GTCCATCCGAT: TCCATCCGATC 
GTCCCAGTGTT: TCCCAGTGTTC 
GTCCCTTCGCA: TCCCTTCGCAT 
GTCCGAAGCCC: TCCGAAGCCCG 
GTCCGGCCCGT: TCCGGCCCGTG 
GTCCGGGTGAG: TCCGGGTGAGG 
GTCCGGTCCCA: TCCGGTCCCAG 
GTCCGGTCCCT: TCCGGTCCCTT 
GTCCGTGACGA: TCCGTGACGAT 
GTCCTGGATGG: TCCTGGATGGC 
GTCGAGCCAAG: TCGAGCCAAGT 
GTCGATAAATT: TCGATAAATTG 
GTCGCAGTAGG: TCGCAGTAGGA 
GTCGCCAGTAG: TCGCCAGTAGG 
GTCGGCACGTT: TCGGCACGTTA 
GTCGGCTTCTG: TCGGCTTCTGT 
GTCGGTCGTCA: TCGGTCGTCAA 
GTCGTACCTCG: TCGTACCTCGT 
GTCGTCAAGCC: TCGTCAAGCCG 
GTCTACACTGC: TCTACACTGCG 
GTCTAGCTATG: TCTAGCTATGG 
GTCTCTTACAG: TCTCTTACAGG 
GTCTGAGCGCA: TCTGAGCGCAA 
GTCTGCCGCAC: TCTGCCGCACC 
GTCTGTTTTTC: TCTGTTTTTCC 
GTCTTGAGTTG: TCTTGAGTTGC 
GTGAAAGGAAG: TGAAAGGAAGG 
GTGAAGAGGAT: TGAAGAGGATA 
GTGAAGCCGTA: TGAAGCCGTAG 
GTGAAGGGTCA: TGAAGGGTCAG 
GTGAATTAATT: TGAATTAATTT 
GTGACCTCGTG: TGACCTCGTGG 
GTGACGATACG: TGACGATACGA 
GTGAGGTATAC: TGAGGTATACA 
GTGATAGACCT: TGATAGACCTT 
GTGATGGAATA: TGATGGAATAC 
GTGCACAATCT: TGCACAATCTC 
GTGCACTCCTT: TGCACTCCTTG 
GTGCATAGGGA: TGCATAGGGAG 
GTGCATAGTGT: TGCATAGTGTG 
GTGCATTTCGC: TGCATTTCGCG 
GTGCCATTACG: TGCCATTACGC 
GTGCCTCTCCT: TGCCTCTCCTG 
GTGCGTTTCCC: TGCGTTTCCCA 
GTGCTTAGAAA: TGCTTAGAAAA 
GTGGACGAGGA: TGGACGAGGAC 
GTGGACGATCC: TGGACGATCCC 
GTGGATCGCAC: TGGATCGCACC 
GTGGGAAGTCG: TGGGAAGTCGG 
GTGGGCAGATA: TGGGCAGATAT 
GTGGGCAGTAG: TGGGCAGTAGT 
GTGGGGGGTTT: TGGGGGGTTTA 
GTGGTTACCTA: TGGTTACCTAA 
GTGTACTAACG: TGTACTAACGT 
GTGTATTCTGC: TGTATTCTGCC 
GTGTATTTCGG: TGTATTTCGGG 
GTGTCAGTGCA: TGTCAGTGCAC 
GTGTCCGAAGC: TGTCCGAAGCC 
GTGTCGATAAA: TGTCGATAAAT 
GTGTGCACAAT: TGTGCACAATC 
GTGTTCAACTA: TGTTCAACTAA 
GTGTTCAGGCG: TGTTCAGGCGC 
GTGTTCGATTA: TGTTCGATTAT 
GTGTTGCCCTC: TGTTGCCCTCG 
GTTAAATGCAC: TTAAATGCACT 
GTTACCGCGGG: TTACCGCGGGA 
GTTACCTAATG: TTACCTAATGC 
GTTACTGGACT: TTACTGGACTG 
GTTAGAGAAAA: TTAGAGAAAAA 
GTTATCATGCT: TTATCATGCTA 
GTTATTAGGTC: TTATTAGGTCC 
GTTCAACTAAG: TTCAACTAAGC 
GTTCAGGCGCT: TTCAGGCGCTT 
GTTCCGAGAGT: TTCCGAGAGTT 
GTTCCTCACGG: TTCCTCACGGC 
GTTCGATTATG: TTCGATTATGC 
GTTCTACATAA: TTCTACATAAC 
GTTCTCAGCCT: TTCTCAGCCTC 
GTTCTCCCACA: TTCTCCCACAT 
GTTCTGGATCC: TTCTGGATCCA 
GTTCTTGTCAA: TTCTTGTCAAG 
GTTGCACGGTG: TTGCACGGTGC 
GTTGCCATGTA: TTGCCATGTAC 
GTTGCCCTCGT: TTGCCCTCGTA 
GTTGGGGAGCC: TTGGGGAGCCC 
GTTGGGTCAAT: TTGGGTCAATG 
GTTTAGCCCCG: TTTAGCCCCGA 
GTTTATCCCAG: TTTATCCCAGA 
GTTTCCAAGGG: TTTCCAAGGGG 
GTTTCCCAGGT: TTTCCCAGGTT 
GTTTCCTGCGT: TTTCCTGCGTG 
GTTTGCCAAAT: TTTGCCAAATC 
GTTTGTAGGAG: TTTGTAGGAGT 
GTTTGTCTGCC: TTTGTCTGCCG 
GTTTTCAGGCG: TTTTCAGGCGA 
GTTTTGGGGTA: TTTTGGGGTAT 
GTTTTTCCAGC: TTTTTCCAGCA 
TAAAAGGTAAT: AAAAGGTAATT 
TAAACATAGGA: AAACATAGGAT 
TAAAGAAGGAG: AAAGAAGGAGC 
TAAATGCACTT: AAATGCACTTA 
TAAATTGATGG: AAATTGATGGC 
TAACAACGTCA: AACAACGTCAG 
TAACCCCAGGA: AACCCCAGGAA 
TAACCGCTTAA: AACCGCTTAAC 
TAACCTAGCTC: AACCTAGCTCA 
TAACGTATTCC: AACGTATTCCC 
TAAGAGGGAGC: AAGAGGGAGCT 
TAAGCTTTGAC: AAGCTTTGACT 
TAAGGGGGGGC: AAGGGGGGGCT 
TAAGTCGTACC: AAGTCGTACCT 
TAATACCTGAG: AATACCTGAGG 
TAATCGCGAAC: AATCGCGAACG 
TAATGAGGGTT: AATGAGGGTTT 
TAATGCAGGTC: AATGCAGGTCG 
TAATGTTGCAC: AATGTTGCACG 
TAATTAGTTAC: AATTAGTTACC 
TAATTATATTC: AATTATATTCC 
TAATTCTCTTG: AATTCTCTTGC 
TAATTGCACAT: AATTGCACATG 
TAATTTATTAT: AATTTATTATA 
TACACCCAGTC: ACACCCAGTCG 
TACACTGCGTT: ACACTGCGTTA 
TACAGGGCACA: ACAGGGCACAC 
TACATAACCTA: ACATAACCTAG 
TACATGTGGGG: ACATGTGGGGG 
TACATTGGTCT: ACATTGGTCTG 
TACCAATACTA: ACCAATACTAA 
TACCCTTTTCT: ACCCTTTTCTA 
TACCGAATTAG: ACCGAATTAGG 
TACCGCCAACA: ACCGCCAACAG 
TACCGCGGGAC: ACCGCGGGACG 
TACCGGTGTCC: ACCGGTGTCCG 
TACCGTCCGGT: ACCGTCCGGTC 
TACCTAATGCA: ACCTAATGCAG 
TACCTCGTAAT: ACCTCGTAATA 
TACCTGAGGGT: ACCTGAGGGTG 
TACCTTAGCTT: ACCTTAGCTTG 
TACGAACGACC: ACGAACGACCA 
TACGAAGGTCT: ACGAAGGTCTA 
TACGACATCAT: ACGACATCATA 
TACGAGCACAG: ACGAGCACAGT 
TACGCACTTGT: ACGCACTTGTT 
TACGCGCCACG: ACGCGCCACGT 
TACGCGCCTAC: ACGCGCCTACC 
TACGCGTAACC: ACGCGTAACCC 
TACGCGTAAGA: ACGCGTAAGAG 
TACGCGTCCGG: ACGCGTCCGGG 
TACGCTTACGT: ACGCTTACGTT 
TACGGAAAGGC: ACGGAAAGGCG 
TACGGGTTCTT: ACGGGTTCTTG 
TACGTATCGGG: ACGTATCGGGT 
TACGTTCCGAG: ACGTTCCGAGA 
TACTAACCGCT: ACTAACCGCTT 
TACTAACGTAT: ACTAACGTATT 
TACTAATGAGG: ACTAATGAGGG 
TACTGGACTGG: ACTGGACTGGA 
TACTGGTTTCC: ACTGGTTTCCT 
TAGAAAATTTA: AGAAAATTTAC 
TAGAACGGTGG: AGAACGGTGGG 
TAGACAGGAAA: AGACAGGAAAC 
TAGACCTTGTT: AGACCTTGTTG 
TAGAGAAAAAT: AGAGAAAAATG 
TAGAGTGATAG: AGAGTGATAGA 
TAGCCCCGAAG: AGCCCCGAAGA 
TAGCGTCGGTC: AGCGTCGGTCG 
TAGCTATGGTA: AGCTATGGTAG 
TAGCTCAGCCC: AGCTCAGCCCA 
TAGCTTCTCCT: AGCTTCTCCTT 
TAGCTTGTAGG: AGCTTGTAGGT 
TAGCTTGTTCC: AGCTTGTTCCT 
TAGGAATCCAA: AGGAATCCAAA 
TAGGACGTTAG: AGGACGTTAGA 
TAGGAGTCCTG: AGGAGTCCTGG 
TAGGAGTTTGC: AGGAGTTTGCC 
TAGGATAAGGG: AGGATAAGGGG 
TAGGATCCTTA: AGGATCCTTAC 
TAGGGAGGGGG: AGGGAGGGGGA 
TAGGGTGCATT: AGGGTGCATTT 
TAGGTCCAATT: AGGTCCAATTG 
TAGGTCCATCC: AGGTCCATCCG 
TAGGTGTATTC: AGGTGTATTCT 
TAGGTGTTGCC: AGGTGTTGCCC 
TAGTATTAGGA: AGTATTAGGAC 
TAGTCGAGCCA: AGTCGAGCCAA 
TAGTGAAGGGT: AGTGAAGGGTC 
TAGTGCCATTA: AGTGCCATTAC 
TAGTGGTTACC: AGTGGTTACCT 
TAGTGTGCACA: AGTGTGCACAA 
TAGTTACCGCG: AGTTACCGCGG 
TATAAAGAAGG: ATAAAGAAGGA 
TATAATTGCAC: ATAATTGCACA 
TATACACCCAG: ATACACCCAGT 
TATACCAATAC: ATACCAATACT 
TATAGAGTGAT: ATAGAGTGATA 
TATAGGAATCC: ATAGGAATCCA 
TATATTATAAA: ATATTATAAAG 
TATATTCCGTA: ATATTCCGTAG 
TATCATGCTAC: ATCATGCTACG 
TATCCCAGAGT: ATCCCAGAGTG 
TATCGGGTCTG: ATCGGGTCTGT 
TATCGTACGCG: ATCGTACGCGC 
TATCGTGGATC: ATCGTGGATCG 
TATGAGTACGC: ATGAGTACGCG 
TATGCACTATT: ATGCACTATTA 
TATGGAATCTT: ATGGAATCTTT 
TATGGTAGCTT: ATGGTAGCTTG 
TATGTCCGGCC: ATGTCCGGCCC 
TATTAATCGCG: ATTAATCGCGA 
TATTAGGACGT: ATTAGGACGTT 
TATTAGGTCCA: ATTAGGTCCAA 
TATTATAAAGA: ATTATAAAGAA 
TATTATAATTG: ATTATAATTGC 
TATTATGAGTA: ATTATGAGTAC 
TATTCCCGGCA: ATTCCCGGCAC 
TATTCCGTAGG: ATTCCGTAGGA 
TATTCCTTCCA: ATTCCTTCCAA 
TATTCTGCCTC: ATTCTGCCTCC 
TATTGTACGAA: ATTGTACGAAG 
TATTTCGGGAA: ATTTCGGGAAT 
TATTTTCCTGC: ATTTTCCTGCA 
TCAACTAAGCT: CAACTAAGCTT 
TCAACTGTAGT: CAACTGTAGTG 
TCAAGCCGATA: CAAGCCGATAC 
TCAAGTTTTCA: CAAGTTTTCAG 
TCAATGGTAGC: CAATGGTAGCT 
TCACAAATTCA: CACAAATTCAC 
TCACAGGGGAG: CACAGGGGAGC 
TCACGCGTATG: CACGCGTATGT 
TCACGGCGCGG: CACGGCGCGGG 
TCACTGGGGAA: CACTGGGGAAT 
TCAGAAGACCC: CAGAAGACCCG 
TCAGACGATAC: CAGACGATACT 
TCAGCCCATCA: CAGCCCATCAA 
TCAGCCCCGAA: CAGCCCCGAAG 
TCAGCCTCGGC: CAGCCTCGGCG 
TCAGGCGACCA: CAGGCGACCAG 
TCAGGCGCTTT: CAGGCGCTTTA 
TCAGTACTGGT: CAGTACTGGTT 
TCAGTGCACTC: CAGTGCACTCC 
TCATACGTATC: CATACGTATCG 
TCATAGTGGTT: CATAGTGGTTA 
TCATCATAGTG: CATCATAGTGG 
TCATGAAGCGG: CATGAAGCGGT 
TCATGCTACGC: CATGCTACGCG 
TCATGTCTACA: CATGTCTACAC 
TCCAAATCACA: CCAAATCACAA 
TCCAACACTAA: CCAACACTAAT 
TCCAACTGCTG: CCAACTGCTGT 
TCCAAGAGCAT: CCAAGAGCATT 
TCCAAGGGGAG: CCAAGGGGAGT 
TCCAATTGATT: CCAATTGATTG 
TCCAGCAATCC: CCAGCAATCCT 
TCCATCCGATC: CCATCCGATCG 
TCCATCGACTA: CCATCGACTAG 
TCCCACATTCG: CCCACATTCGC 
TCCCAGAGTGG: CCCAGAGTGGA 
TCCCAGGTTAC: CCCAGGTTACT 
TCCCAGTGTTC: CCCAGTGTTCA 
TCCCCAGTAAG: CCCCAGTAAGT 
TCCCGGCACAA: CCCGGCACAAG 
TCCCGTGGACG: CCCGTGGACGA 
TCCCTATTCCT: CCCTATTCCTT 
TCCCTTCGCAT: CCCTTCGCATC 
TCCGAAGCCCG: CCGAAGCCCGA 
TCCGAGAGTTT: CCGAGAGTTTA 
TCCGATCGGCG: CCGATCGGCGA 
TCCGGCCCGTG: CCGGCCCGTGT 
TCCGGGTGAGG: CCGGGTGAGGT 
TCCGGTCCCAG: CCGGTCCCAGT 
TCCGGTCCCTT: CCGGTCCCTTC 
TCCGTAGGAGT: CCGTAGGAGTC 
TCCGTGACGAT: CCGTGACGATA 
TCCTCACGGCG: CCTCACGGCGC 
TCCTGAACCAA: CCTGAACCAAA 
TCCTGCAATAC: CCTGCAATACG 
TCCTGCGTGCG: CCTGCGTGCGT 
TCCTGGACCAC: CCTGGACCACG 
TCCTGGATGGC: CCTGGATGGCA 
TCCTTACGCGT: CCTTACGCGTA 
TCCTTCCAACT: CCTTCCAACTG 
TCCTTCTCCAA: CCTTCTCCAAC 
TCCTTGCCATG: CCTTGCCATGG 
TCCTTTTACCG: CCTTTTACCGG 
TCGAAAATGCA: CGAAAATGCAA 
TCGACAAACGC: CGACAAACGCG 
TCGACTAGAAC: CGACTAGAACG 
TCGAGCCAAGT: CGAGCCAAGTT 
TCGATAAATTG: CGATAAATTGA 
TCGATTATGCA: CGATTATGCAC 
TCGCACCCTCG: CGCACCCTCGA 
TCGCAGTAGGA: CGCAGTAGGAT 
TCGCATCGTTT: CGCATCGTTTC 
TCGCCAGTAGG: CGCCAGTAGGT 
TCGCGAACGAT: CGCGAACGATG 
TCGCGAGCGTT: CGCGAGCGTTT 
TCGCGGATGTC: CGCGGATGTCT 
TCGCTGATATT: CGCTGATATTA 
TCGGAACGACG: CGGAACGACGT 
TCGGCACGTTA: CGGCACGTTAT 
TCGGCGAAGTA: CGGCGAAGTAT 
TCGGCGCGCAG: CGGCGCGCAGC 
TCGGCTTCTGT: CGGCTTCTGTT 
TCGGGAATAAC: CGGGAATAACA 
TCGGGTCTGTT: CGGGTCTGTTT 
TCGGTCGTCAA: CGGTCGTCAAG 
TCGTAATACCT: CGTAATACCTG 
TCGTACCTCGT: CGTACCTCGTA 
TCGTACGCGCC: CGTACGCGCCT 
TCGTATAGGAA: CGTATAGGAAT 
TCGTCAAGCCG: CGTCAAGCCGA 
TCGTGGATCGC: CGTGGATCGCA 
TCGTGGGCAGT: CGTGGGCAGTA 
TCGTTTCCAAG: CGTTTCCAAGG 
TCTACACTGCG: CTACACTGCGT 
TCTACATAACC: CTACATAACCT 
TCTACATGTGG: CTACATGTGGG 
TCTAGCTATGG: CTAGCTATGGT 
TCTAGTGAAGG: CTAGTGAAGGG 
TCTATAGAGTG: CTATAGAGTGA 
TCTCAGCCTCG: CTCAGCCTCGG 
TCTCCAACACT: CTCCAACACTA 
TCTCCCACATT: CTCCCACATTC 
TCTCCTGGACC: CTCCTGGACCA 
TCTCCTTCTCC: CTCCTTCTCCA 
TCTCTACATGT: CTCTACATGTG 
TCTCTGATGAT: CTCTGATGATC 
TCTCTTACAGG: CTCTTACAGGG 
TCTCTTGCTCA: CTCTTGCTCAC 
TCTGAGCGCAA: CTGAGCGCAAG 
TCTGATGATCA: CTGATGATCAG 
TCTGCCGCACC: CTGCCGCACCG 
TCTGCCTCCTT: CTGCCTCCTTT 
TCTGGATCCAA: CTGGATCCAAG 
TCTGGGAGAAA: CTGGGAGAAAG 
TCTGTTGGGGA: CTGTTGGGGAG 
TCTGTTTTTCC: CTGTTTTTCCA 
TCTTACAGGGC: CTTACAGGGCA 
TCTTGAGTTGC: CTTGAGTTGCC 
TCTTGCTCACA: CTTGCTCACAG 
TCTTGGAGTCG: CTTGGAGTCGC 
TCTTGTCAAGT: CTTGTCAAGTT 
TCTTTCATGAA: CTTTCATGAAG 
TCTTTTCTCTA: CTTTTCTCTAC 
TGAAAACGCGA: GAAAACGCGAC 
TGAAAGGAAGG: GAAAGGAAGGG 
TGAACATTTGA: GAACATTTGAA 
TGAACCAAAAC: GAACCAAAACT 
TGAACTTTGAA: GAACTTTGAAA 
TGAAGAGGATA: GAAGAGGATAA 
TGAAGCCGTAG: GAAGCCGTAGA 
TGAAGCGGTGC: GAAGCGGTGCA 
TGAAGGGTCAG: GAAGGGTCAGT 
TGAATTAATTT: GAATTAATTTA 
TGAATTCTTGG: GAATTCTTGGA 
TGACCTCGTGG: GACCTCGTGGG 
TGACGATACGA: GACGATACGAC 
TGACTGATTGA: GACTGATTGAG 
TGAGCGCAAGT: GAGCGCAAGTG 
TGAGGGTGAAA: GAGGGTGAAAG 
TGAGGGTTTGT: GAGGGTTTGTA 
TGAGGTATACA: GAGGTATACAC 
TGAGGTGTACT: GAGGTGTACTA 
TGAGTACGCGT: GAGTACGCGTC 
TGAGTTGCCAT: GAGTTGCCATG 
TGATAGACCTT: GATAGACCTTG 
TGATATTAATC: GATATTAATCG 
TGATCAGACGA: GATCAGACGAT 
TGATCTGGGAG: GATCTGGGAGA 
TGATGATCAGA: GATGATCAGAC 
TGATGGAATAC: GATGGAATACG 
TGATGGCGCTA: GATGGCGCTAT 
TGATTGAACAT: GATTGAACATT 
TGATTGAGGTG: GATTGAGGTGT 
TGCAAGAACCC: GCAAGAACCCA 
TGCAAGCCCCC: GCAAGCCCCCA 
TGCAATACGAG: GCAATACGAGC 
TGCACAATCTC: GCACAATCTCT 
TGCACATGTGT: GCACATGTGTT 
TGCACGGTGCT: GCACGGTGCTT 
TGCACTATTAT: GCACTATTATG 
TGCACTCCTTG: GCACTCCTTGC 
TGCACTTAGTC: GCACTTAGTCG 
TGCAGGTCGGC: GCAGGTCGGCT 
TGCATAGGGAG: GCATAGGGAGG 
TGCATAGTGTG: GCATAGTGTGC 
TGCATGAATTC: GCATGAATTCT 
TGCATTTCGCG: GCATTTCGCGA 
TGCCAAATCAG: GCCAAATCAGA 
TGCCATGGATA: GCCATGGATAG 
TGCCATGTACG: GCCATGTACGG 
TGCCATTACGC: GCCATTACGCT 
TGCCCTCGTAT: GCCCTCGTATA 
TGCCGCACCGT: GCCGCACCGTA 
TGCCTCCTTTT: GCCTCCTTTTA 
TGCCTCTCCTG: GCCTCTCCTGG 
TGCGTGCGTTT: GCGTGCGTTTC 
TGCGTTATCAT: GCGTTATCATG 
TGCGTTTCCCA: GCGTTTCCCAG 
TGCTACGCGCC: GCTACGCGCCA 
TGCTACGCGTA: GCTACGCGTAA 
TGCTCACAGGG: GCTCACAGGGG 
TGCTGTCACTG: GCTGTCACTGG 
TGCTTAGAAAA: GCTTAGAAAAT 
TGGAATACGAA: GGAATACGAAC 
TGGAATCTTTC: GGAATCTTTCA 
TGGACCAATCC: GGACCAATCCC 
TGGACCACGTC: GGACCACGTCC 
TGGACGAGGAC: GGACGAGGACC 
TGGACGATCCC: GGACGATCCCG 
TGGACTGGAGT: GGACTGGAGTG 
TGGAGTCGCCA: GGAGTCGCCAG 
TGGAGTGAAGC: GGAGTGAAGCC 
TGGATAGGGTG: GGATAGGGTGC 
TGGATCCAAGA: GGATCCAAGAG 
TGGATCGCACC: GGATCGCACCC 
TGGATGGCATT: GGATGGCATTG 
TGGCATTGCAT: GGCATTGCATG 
TGGCGCTATAT: GGCGCTATATT 
TGGGAAGTCGG: GGGAAGTCGGC 
TGGGAGAAAGT: GGGAGAAAGTC 
TGGGCAGATAT: GGGCAGATATT 
TGGGCAGTAGT: GGGCAGTAGTA 
TGGGGAATTTT: GGGGAATTTTC 
TGGGGAGCCCT: GGGGAGCCCTC 
TGGGGGACGCC: GGGGGACGCCC 
TGGGGGGTTTA: GGGGGGTTTAT 
TGGGGTATGGA: GGGGTATGGAA 
TGGGTCAATGG: GGGTCAATGGT 
TGGGTGAAGAG: GGGTGAAGAGG 
TGGGTTAAATG: GGGTTAAATGC 
TGGTAGCTTCT: GGTAGCTTCTC 
TGGTAGCTTGT: GGTAGCTTGTT 
TGGTCTGAGCG: GGTCTGAGCGC 
TGGTTACCTAA: GGTTACCTAAT 
TGGTTTCCTGC: GGTTTCCTGCG 
TGTACGAAGGT: GTACGAAGGTC 
TGTACGGGTTC: GTACGGGTTCT 
TGTACTAACGT: GTACTAACGTA 
TGTAGGAGTTT: GTAGGAGTTTG 
TGTAGGTGTAT: GTAGGTGTATT 
TGTAGTGCCAT: GTAGTGCCATT 
TGTATTCTGCC: GTATTCTGCCT 
TGTATTTCGGG: GTATTTCGGGA 
TGTCAAGTTTT: GTCAAGTTTTC 
TGTCACTGGGG: GTCACTGGGGA 
TGTCAGTGCAC: GTCAGTGCACT 
TGTCCGAAGCC: GTCCGAAGCCC 
TGTCCGGCCCG: GTCCGGCCCGT 
TGTCGATAAAT: GTCGATAAATT 
TGTCTACACTG: GTCTACACTGC 
TGTCTGCCGCA: GTCTGCCGCAC 
TGTCTTGAGTT: GTCTTGAGTTG 
TGTGCACAATC: GTGCACAATCT 
TGTGCATAGTG: GTGCATAGTGT 
TGTGGGAAGTC: GTGGGAAGTCG 
TGTGGGGGGTT: GTGGGGGGTTT 
TGTGTATTTCG: GTGTATTTCGG 
TGTGTTCAGGC: GTGTTCAGGCG 
TGTTCAACTAA: GTTCAACTAAG 
TGTTCAGGCGC: GTTCAGGCGCT 
TGTTCCTCACG: GTTCCTCACGG 
TGTTCGATTAT: GTTCGATTATG 
TGTTGCACGGT: GTTGCACGGTG 
TGTTGCCCTCG: GTTGCCCTCGT 
TGTTGGGGAGC: GTTGGGGAGCC 
TGTTGGGTCAA: GTTGGGTCAAT 
TGTTTTGGGGT: GTTTTGGGGTA 
TGTTTTTCCAG: GTTTTTCCAGC 
TTAAAAGGTAA: TAAAAGGTAAT 
TTAAATGCACT: TAAATGCACTT 
TTAATCGCGAA: TAATCGCGAAC 
TTAATTTATTA: TAATTTATTAT 
TTACAGGGCAC: TACAGGGCACA 
TTACATTGGTC: TACATTGGTCT 
TTACCCTTTTC: TACCCTTTTCT 
TTACCGCGGGA: TACCGCGGGAC 
TTACCGGTGTC: TACCGGTGTCC 
TTACCTAATGC: TACCTAATGCA 
TTACGCACTTG: TACGCACTTGT 
TTACGCGTAAC: TACGCGTAACC 
TTACGCTTACG: TACGCTTACGT 
TTACGGAAAGG: TACGGAAAGGC 
TTACGTTCCGA: TACGTTCCGAG 
TTACTGGACTG: TACTGGACTGG 
TTAGAAAATTT: TAGAAAATTTA 
TTAGAGAAAAA: TAGAGAAAAAT 
TTAGCCCCGAA: TAGCCCCGAAG 
TTAGCTTGTAG: TAGCTTGTAGG 
TTAGGACGTTA: TAGGACGTTAG 
TTAGGTCCAAT: TAGGTCCAATT 
TTAGGTGTTGC: TAGGTGTTGCC 
TTAGTCGAGCC: TAGTCGAGCCA 
TTAGTTACCGC: TAGTTACCGCG 
TTATAAAGAAG: TATAAAGAAGG 
TTATAATTGCA: TATAATTGCAC 
TTATATTCCGT: TATATTCCGTA 
TTATCATGCTA: TATCATGCTAC 
TTATCCCAGAG: TATCCCAGAGT 
TTATCGTACGC: TATCGTACGCG 
TTATGAGTACG: TATGAGTACGC 
TTATGCACTAT: TATGCACTATT 
TTATTAGGTCC: TATTAGGTCCA 
TTATTATAATT: TATTATAATTG 
TTCAACTAAGC: TCAACTAAGCT 
TTCACGCGTAT: TCACGCGTATG 
TTCAGGCGACC: TCAGGCGACCA 
TTCAGGCGCTT: TCAGGCGCTTT 
TTCATCATAGT: TCATCATAGTG 
TTCATGAAGCG: TCATGAAGCGG 
TTCCAACTGCT: TCCAACTGCTG 
TTCCAAGGGGA: TCCAAGGGGAG 
TTCCAGCAATC: TCCAGCAATCC 
TTCCCAGGTTA: TCCCAGGTTAC 
TTCCCGGCACA: TCCCGGCACAA 
TTCCGAGAGTT: TCCGAGAGTTT 
TTCCGTAGGAG: TCCGTAGGAGT 
TTCCTCACGGC: TCCTCACGGCG 
TTCCTGCAATA: TCCTGCAATAC 
TTCCTGCGTGC: TCCTGCGTGCG 
TTCCTTCCAAC: TCCTTCCAACT 
TTCGATTATGC: TCGATTATGCA 
TTCGCATCGTT: TCGCATCGTTT 
TTCGCGAGCGT: TCGCGAGCGTT 
TTCGCGGATGT: TCGCGGATGTC 
TTCGCTGATAT: TCGCTGATATT 
TTCGGAACGAC: TCGGAACGACG 
TTCGGGAATAA: TCGGGAATAAC 
TTCTACATAAC: TCTACATAACC 
TTCTATAGAGT: TCTATAGAGTG 
TTCTCAGCCTC: TCTCAGCCTCG 
TTCTCCAACAC: TCTCCAACACT 
TTCTCCCACAT: TCTCCCACATT 
TTCTCCTTCTC: TCTCCTTCTCC 
TTCTCTACATG: TCTCTACATGT 
TTCTCTTGCTC: TCTCTTGCTCA 
TTCTGCCTCCT: TCTGCCTCCTT 
TTCTGGATCCA: TCTGGATCCAA 
TTCTGTTGGGG: TCTGTTGGGGA 
TTCTTGGAGTC: TCTTGGAGTCG 
TTCTTGTCAAG: TCTTGTCAAGT 
TTCTTTTCTCT: TCTTTTCTCTA 
TTGAAAACGCG: TGAAAACGCGA 
TTGAACATTTG: TGAACATTTGA 
TTGAACTTTGA: TGAACTTTGAA 
TTGACTGATTG: TGACTGATTGA 
TTGAGGTGTAC: TGAGGTGTACT 
TTGAGTTGCCA: TGAGTTGCCAT 
TTGATGGCGCT: TGATGGCGCTA 
TTGATTGAACA: TGATTGAACAT 
TTGCACATGTG: TGCACATGTGT 
TTGCACGGTGC: TGCACGGTGCT 
TTGCATGAATT: TGCATGAATTC 
TTGCCAAATCA: TGCCAAATCAG 
TTGCCATGGAT: TGCCATGGATA 
TTGCCATGTAC: TGCCATGTACG 
TTGCCCTCGTA: TGCCCTCGTAT 
TTGCTCACAGG: TGCTCACAGGG 
TTGGAGTCGCC: TGGAGTCGCCA 
TTGGGGAGCCC: TGGGGAGCCCT 
TTGGGGTATGG: TGGGGTATGGA 
TTGGGTCAATG: TGGGTCAATGG 
TTGGGTGAAGA: TGGGTGAAGAG 
TTGGTCTGAGC: TGGTCTGAGCG 
TTGTACGAAGG: TGTACGAAGGT 
TTGTAGGAGTT: TGTAGGAGTTT 
TTGTAGGTGTA: TGTAGGTGTAT 
TTGTCAAGTTT: TGTCAAGTTTT 
TTGTCTGCCGC: TGTCTGCCGCA 
TTGTGCATAGT: TGTGCATAGTG 
TTGTTCCTCAC: TGTTCCTCACG 
TTGTTGGGTCA: TGTTGGGTCAA 
TTGTTTTGGGG: TGTTTTGGGGT 
TTTAAAAGGTA: TTAAAAGGTAA 
TTTACATTGGT: TTACATTGGTC 
TTTACCCTTTT: TTACCCTTTTC 
TTTACCGGTGT: TTACCGGTGTC 
TTTAGCCCCGA: TTAGCCCCGAA 
TTTATCCCAGA: TTATCCCAGAG 
TTTATTATAAT: TTATTATAATT 
TTTCAGGCGAC: TTCAGGCGACC 
TTTCATCATAG: TTCATCATAGT 
TTTCATGAAGC: TTCATGAAGCG 
TTTCCAAGGGG: TTCCAAGGGGA 
TTTCCAGCAAT: TTCCAGCAATC 
TTTCCCAGGTT: TTCCCAGGTTA 
TTTCCTGCAAT: TTCCTGCAATA 
TTTCCTGCGTG: TTCCTGCGTGC 
TTTCGCGAGCG: TTCGCGAGCGT 
TTTCGGAACGA: TTCGGAACGAC 
TTTCGGGAATA: TTCGGGAATAA 
TTTCTATAGAG: TTCTATAGAGT 
TTTCTCTACAT: TTCTCTACATG 
TTTGAAAACGC: TTGAAAACGCG 
TTTGAACTTTG: TTGAACTTTGA 
TTTGACTGATT: TTGACTGATTG 
TTTGCCAAATC: TTGCCAAATCA 
TTTGGGGTATG: TTGGGGTATGG 
TTTGTAGGAGT: TTGTAGGAGTT 
TTTGTCTGCCG: TTGTCTGCCGC 
TTTTACCGGTG: TTTACCGGTGT 
TTTTCAGGCGA: TTTCAGGCGAC 
TTTTCCAGCAA: TTTCCAGCAAT 
TTTTCCTGCAA: TTTCCTGCAAT 
TTTTCGGAACG: TTTCGGAACGA 
TTTTCTATAGA: TTTCTATAGAG 
TTTTCTCTACA: TTTCTCTACAT 
TTTTGGGGTAT: TTTGGGGTATG 
TTTTTCCAGCA: TTTTCCAGCAA 
