AAAACTTATACACGCCAAT: AAACTTATACACGCCAATT
AAAAGAGGGGGACCCTTCA: AAAGAGGGGGACCCTTCAT
AAAAGCAAACCCGTACAAG: AAAGCAAACCCGTACAAGA
AAACAGTTTGACCGACTCG: AACAGTTTGACCGACTCGT
AAACATCGGGGCGGGAACC: AACATCGGGGCGGGAACCT
AAACCCGTACAAGACAAAA: AACCCGTACAAGACAAAAG
AAACGGTCTAAGCGCCTGC: AACGGTCTAAGCGCCTGCC
AAACTTATACACGCCAATT: AACTTATACACGCCAATTT
AAACTTGGAGGCAATGATG: AACTTGGAGGCAATGATGT
AAAGAGGGGGACCCTTCAT: AAGAGGGGGACCCTTCATA
AAAGAGTGGATAAAAGCAA: AAGAGTGGATAAAAGCAAA
AAAGCAAACCCGTACAAGA: AAGCAAACCCGTACAAGAC
AAAGCATAAATATTAACTC: AAGCATAAATATTAACTCG
AAAGCTAGCTAGGGGATCC: AAGCTAGCTAGGGGATCCT
AAAGGCCAGCCGGTCAACT: AAGGCCAGCCGGTCAACTT
AAAGGCCTGCGCCAAGCTG: AAGGCCTGCGCCAAGCTGC
AAAGGCTCGGCTAATCGCG: AAGGCTCGGCTAATCGCGC
AAATACATGGCGCATCGCG: AATACATGGCGCATCGCGA
AAATATACGCACAATACAC: AATATACGCACAATACACC
AAATATTAACTCGCAGATC: AATATTAACTCGCAGATCT
AAATCCTCTTCACGCACAT: AATCCTCTTCACGCACATC
AAATTAGACTGCGGGCGGG: AATTAGACTGCGGGCGGGT
AACAAGCTAGACGCGTAAA: ACAAGCTAGACGCGTAAAT
AACAATTCTCGCCTACCCC: ACAATTCTCGCCTACCCCA
AACACCCAATATCTGACGG: ACACCCAATATCTGACGGC
AACAGAACGCAATAACTGG: ACAGAACGCAATAACTGGA
AACAGGCTAGATACTGTGA: ACAGGCTAGATACTGTGAG
AACAGTTTGACCGACTCGT: ACAGTTTGACCGACTCGTC
AACATAGATCAGTGGTCGA: ACATAGATCAGTGGTCGAG
AACATCACGACATGAATGC: ACATCACGACATGAATGCT
AACATCGGGGCGGGAACCT: ACATCGGGGCGGGAACCTG
AACATTTACAGATCTAGTT: ACATTTACAGATCTAGTTT
AACCCGTACAAGACAAAAG: ACCCGTACAAGACAAAAGA
AACCCTAGGGGAAGTCCCA: ACCCTAGGGGAAGTCCCAG
AACCCTCATTTTATCTCAT: ACCCTCATTTTATCTCATA
AACCTGCTCAATGGCCGCG: ACCTGCTCAATGGCCGCGC
AACGAAGTAGAGCGGGTGA: ACGAAGTAGAGCGGGTGAT
AACGATAGCGAAGCCGCCC: ACGATAGCGAAGCCGCCCT
AACGCAATAACTGGAGTTT: ACGCAATAACTGGAGTTTA
AACGCCTGTTATTAACTCG: ACGCCTGTTATTAACTCGC
AACGGCCGAAACAGTTTGA: ACGGCCGAAACAGTTTGAC
AACGGGCGGGCTTAAGCTG: ACGGGCGGGCTTAAGCTGT
AACGGTCTAAGCGCCTGCC: ACGGTCTAAGCGCCTGCCA
AACGTAACGATAGCGAAGC: ACGTAACGATAGCGAAGCC
AACTATTAACTCGCAGATC: ACTATTAACTCGCAGATCT
AACTATTTACGGTTATGCC: ACTATTTACGGTTATGCCC
AACTCGCAGATCTCATATC: ACTCGCAGATCTCATATCG
AACTCGCAGATCTCCTGTA: ACTCGCAGATCTCCTGTAT
AACTCGCAGATCTCGGCAG: ACTCGCAGATCTCGGCAGA
AACTCGCAGATCTCTACGG: ACTCGCAGATCTCTACGGT
AACTGCCCCACACTGCACG: ACTGCCCCACACTGCACGG
AACTGCGCCGCTGTATTCA: ACTGCGCCGCTGTATTCAA
AACTGGAGTTTAGAGGAAG: ACTGGAGTTTAGAGGAAGA
AACTGGCGGGAAATACATG: ACTGGCGGGAAATACATGG
AACTTATACACGCCAATTT: ACTTATACACGCCAATTTG
AACTTGGAGGCAATGATGT: ACTTGGAGGCAATGATGTG
AACTTGTCGATAGGCGGAC: ACTTGTCGATAGGCGGACG
AACTTTAATTAGATGGTAT: ACTTTAATTAGATGGTATT
AAGAAAGGCTCGGCTAATC: AGAAAGGCTCGGCTAATCG
AAGAATCTATCGTGTACAT: AGAATCTATCGTGTACATT
AAGACAAAAGAGGGGGACC: AGACAAAAGAGGGGGACCC
AAGACTTGGAAATCCTCTT: AGACTTGGAAATCCTCTTC
AAGAGGGGGACCCTTCATA: AGAGGGGGACCCTTCATAC
AAGAGTGGATAAAAGCAAA: AGAGTGGATAAAAGCAAAC
AAGCAAACCCGTACAAGAC: AGCAAACCCGTACAAGACA
AAGCATAAATATTAACTCG: AGCATAAATATTAACTCGC
AAGCATGGAATTCGAGTCC: AGCATGGAATTCGAGTCCC
AAGCCGCCCTCACACTTCA: AGCCGCCCTCACACTTCAA
AAGCGAACCCTAGGGGAAG: AGCGAACCCTAGGGGAAGT
AAGCGCCTGCCACCAACGC: AGCGCCTGCCACCAACGCC
AAGCGGACCATCTTTCCCG: AGCGGACCATCTTTCCCGC
AAGCGTTCGGACGCATTGA: AGCGTTCGGACGCATTGAG
AAGCTAGACGCGTAAATAT: AGCTAGACGCGTAAATATA
AAGCTAGCTAGGGGATCCT: AGCTAGCTAGGGGATCCTC
AAGCTGCCATCCCGGCTGA: AGCTGCCATCCCGGCTGAC
AAGCTGTAACAGGCTAGAT: AGCTGTAACAGGCTAGATA
AAGGCCAGCCGGTCAACTT: AGGCCAGCCGGTCAACTTG
AAGGCCGCTCTCGCGATCG: AGGCCGCTCTCGCGATCGC
AAGGCCTGCGCCAAGCTGC: AGGCCTGCGCCAAGCTGCC
AAGGCTCGGCTAATCGCGC: AGGCTCGGCTAATCGCGCC
AAGGGGCTTGACGTGCGAG: AGGGGCTTGACGTGCGAGT
AAGGGTAGAGTATACCTAC: AGGGTAGAGTATACCTACA
AAGTAGAACCCTCATTTTA: AGTAGAACCCTCATTTTAT
AAGTAGAGCGGGTGATTCT: AGTAGAGCGGGTGATTCTG
AAGTCCCAGCATGTCCCGA: AGTCCCAGCATGTCCCGAC
AAGTCGGGTATCATTGCAG: AGTCGGGTATCATTGCAGG
AAGTTTGAGTGAAGGCCGC: AGTTTGAGTGAAGGCCGCT
AATAAATTAGACTGCGGGC: ATAAATTAGACTGCGGGCG
AATAACTGGAGTTTAGAGG: ATAACTGGAGTTTAGAGGA
AATAAGAATCTATCGTGTA: ATAAGAATCTATCGTGTAC
AATAATACAGTGTACACAC: ATAATACAGTGTACACACG
AATACACCGTGGGATCCGT: ATACACCGTGGGATCCGTG
AATACAGTGTACACACGAA: ATACAGTGTACACACGAAT
AATACATGGCGCATCGCGA: ATACATGGCGCATCGCGAT
AATAGGGTTGTAACGTAAC: ATAGGGTTGTAACGTAACG
AATATACGCACAATACACC: ATATACGCACAATACACCG
AATATCTGACGGCGGGCAC: ATATCTGACGGCGGGCACT
AATATTAACTCGCAGATCT: ATATTAACTCGCAGATCTC
AATCCTCTTCACGCACATC: ATCCTCTTCACGCACATCA
AATCGCGCCCGTTATAATT: ATCGCGCCCGTTATAATTA
AATCGGCGTTTATCATAAT: ATCGGCGTTTATCATAATT
AATCTATCGTGTACATTCA: ATCTATCGTGTACATTCAC
AATCTGAATGGGATTATCG: ATCTGAATGGGATTATCGA
AATCTTCCAACATTTACAG: ATCTTCCAACATTTACAGA
AATGATGTGACGAATGCCT: ATGATGTGACGAATGCCTT
AATGATTCTCGGTCAAAAC: ATGATTCTCGGTCAAAACT
AATGCCTTTGCCATTGCCG: ATGCCTTTGCCATTGCCGA
AATGCTCTTGAGAACTGCC: ATGCTCTTGAGAACTGCCC
AATGGCCGCGCTGTTATGC: ATGGCCGCGCTGTTATGCT
AATGGGATTATCGATATGG: ATGGGATTATCGATATGGT
AATTAATAAGAATCTATCG: ATTAATAAGAATCTATCGT
AATTAGACTGCGGGCGGGT: ATTAGACTGCGGGCGGGTC
AATTAGATGGTATTCCAAA: ATTAGATGGTATTCCAAAC
AATTAGCCTACTACTTGCA: ATTAGCCTACTACTTGCAC
AATTCGAGTCCCTGCGGCT: ATTCGAGTCCCTGCGGCTA
AATTCTAGGCATCCGCACC: ATTCTAGGCATCCGCACCG
AATTCTCGCCTACCCCACT: ATTCTCGCCTACCCCACTC
AATTGACGCCCTTTGATGC: ATTGACGCCCTTTGATGCT
AATTGCTGTCATGCGAGTT: ATTGCTGTCATGCGAGTTC
AATTTCGGGGTCGGGTCCC: ATTTCGGGGTCGGGTCCCG
AATTTGAGCGACGTAAGGG: ATTTGAGCGACGTAAGGGT
ACAAAAGAGGGGGACCCTT: CAAAAGAGGGGGACCCTTC
ACAAGACAAAAGAGGGGGA: CAAGACAAAAGAGGGGGAC
ACAAGCGTTCGGACGCATT: CAAGCGTTCGGACGCATTG
ACAAGCTAGACGCGTAAAT: CAAGCTAGACGCGTAAATA
ACAATACACCGTGGGATCC: CAATACACCGTGGGATCCG
ACAATTCTAGGCATCCGCA: CAATTCTAGGCATCCGCAC
ACAATTCTCGCCTACCCCA: CAATTCTCGCCTACCCCAC
ACACACGAATCTGAATGGG: CACACGAATCTGAATGGGA
ACACATATTGTCGCTAGCG: CACATATTGTCGCTAGCGT
ACACCCAATATCTGACGGC: CACCCAATATCTGACGGCG
ACACCGTGGGATCCGTGTC: CACCGTGGGATCCGTGTCT
ACACGAATCTGAATGGGAT: CACGAATCTGAATGGGATT
ACACGCCAATTTGAGCGAC: CACGCCAATTTGAGCGACG
ACACGGCTTGGGCCACGGT: CACGGCTTGGGCCACGGTA
ACACTGCACGGCACAGCGC: CACTGCACGGCACAGCGCC
ACACTTCAAAGGCCTGCGC: CACTTCAAAGGCCTGCGCC
ACAGAACAGAACGCAATAA: CAGAACAGAACGCAATAAC
ACAGAACGCAATAACTGGA: CAGAACGCAATAACTGGAG
ACAGAGTGAGGGCCGCGGC: CAGAGTGAGGGCCGCGGCG
ACAGATCTAGTTTTACTCT: CAGATCTAGTTTTACTCTG
ACAGCGCCCGGGCCATTAA: CAGCGCCCGGGCCATTAAT
ACAGCTGACCGCGGCATAC: CAGCTGACCGCGGCATACC
ACAGCTGCCTTTGGGATAC: CAGCTGCCTTTGGGATACT
ACAGGCTAGATACTGTGAG: CAGGCTAGATACTGTGAGC
ACAGTGTACACACGAATCT: CAGTGTACACACGAATCTG
ACAGTTTGACCGACTCGTC: CAGTTTGACCGACTCGTCC
ACATAGATCAGTGGTCGAG: CATAGATCAGTGGTCGAGC
ACATATTATCGCTAGGATA: CATATTATCGCTAGGATAG
ACATATTGTCGCTAGCGTC: CATATTGTCGCTAGCGTCA
ACATCAACAAGCTAGACGC: CATCAACAAGCTAGACGCG
ACATCACGACATGAATGCT: CATCACGACATGAATGCTC
ACATCACGCATACATCTAT: CATCACGCATACATCTATC
ACATCGGGGCGGGAACCTG: CATCGGGGCGGGAACCTGC
ACATCTATCCTGTGCAAAG: CATCTATCCTGTGCAAAGC
ACATGAATGCTCTTGAGAA: CATGAATGCTCTTGAGAAC
ACATGGCGCATCGCGATAA: CATGGCGCATCGCGATAAA
ACATTATCAACTATTAACT: CATTATCAACTATTAACTC
ACATTCACAAGCGTTCGGA: CATTCACAAGCGTTCGGAC
ACATTTACAGATCTAGTTT: CATTTACAGATCTAGTTTT
ACCAACGCCTGTTATTAAC: CCAACGCCTGTTATTAACT
ACCACAGAGTGAGGGCCGC: CCACAGAGTGAGGGCCGCG
ACCAGTTATAGCTCCCTTA: CCAGTTATAGCTCCCTTAT
ACCATAATCTTCCAACATT: CCATAATCTTCCAACATTT
ACCATATTACGCGGTCGCG: CCATATTACGCGGTCGCGT
ACCATCTTTCCCGCACGTC: CCATCTTTCCCGCACGTCC
ACCCAATATCTGACGGCGG: CCCAATATCTGACGGCGGG
ACCCCACTCGTGAGTATAA: CCCCACTCGTGAGTATAAC
ACCCGAGGGCTGTTGTGAC: CCCGAGGGCTGTTGTGACC
ACCCGATCAGTGGTCGAGC: CCCGATCAGTGGTCGAGCA
ACCCGCATCCGTGTCAACT: CCCGCATCCGTGTCAACTG
ACCCGGACGCCCATTGATG: CCCGGACGCCCATTGATGT
ACCCGTACAAGACAAAAGA: CCCGTACAAGACAAAAGAG
ACCCTAGGGGAAGTCCCAG: CCCTAGGGGAAGTCCCAGC
ACCCTCATTTTATCTCATA: CCCTCATTTTATCTCATAT
ACCCTCGTCTTGGTAAGCG: CCCTCGTCTTGGTAAGCGA
ACCCTTATCGCATGCTTGC: CCCTTATCGCATGCTTGCG
ACCCTTCATACATCAACAA: CCCTTCATACATCAACAAG
ACCGACTCGTCCATATGGC: CCGACTCGTCCATATGGCC
ACCGCGGCATACCCGAGGG: CCGCGGCATACCCGAGGGC
ACCGTAGTCAGTGACATAT: CCGTAGTCAGTGACATATT
ACCGTGGGATCCGTGTCTA: CCGTGGGATCCGTGTCTAT
ACCTACAGAACAGAACGCA: CCTACAGAACAGAACGCAA
ACCTGCTCAATGGCCGCGC: CCTGCTCAATGGCCGCGCT
ACCTGTTGCTTTCAGGCTG: CCTGTTGCTTTCAGGCTGA
ACCTTTATCCAATTGACGC: CCTTTATCCAATTGACGCC
ACGAAGTAGAGCGGGTGAT: CGAAGTAGAGCGGGTGATT
ACGAATCTGAATGGGATTA: CGAATCTGAATGGGATTAT
ACGAATGCCTTTGCCATTG: CGAATGCCTTTGCCATTGC
ACGACATGAATGCTCTTGA: CGACATGAATGCTCTTGAG
ACGAGCCAGCCAAGCATGG: CGAGCCAGCCAAGCATGGA
ACGATAGCGAAGCCGCCCT: CGATAGCGAAGCCGCCCTC
ACGCAATAACTGGAGTTTA: CGCAATAACTGGAGTTTAG
ACGCACAATACACCGTGGG: CGCACAATACACCGTGGGA
ACGCACATCACGCATACAT: CGCACATCACGCATACATC
ACGCATACATCTATCCTGT: CGCATACATCTATCCTGTG
ACGCATTGAGTACCTGTTG: CGCATTGAGTACCTGTTGC
ACGCCAATTTGAGCGACGT: CGCCAATTTGAGCGACGTA
ACGCCCATTGATGTGATCC: CGCCCATTGATGTGATCCT
ACGCCCTTTGATGCTCAAG: CGCCCTTTGATGCTCAAGG
ACGCCTGTTATTAACTCGC: CGCCTGTTATTAACTCGCA
ACGCGGTCGCGTATATAGG: CGCGGTCGCGTATATAGGC
ACGCGTAAATATACGCACA: CGCGTAAATATACGCACAA
ACGCGTCGGCCATATCGTG: CGCGTCGGCCATATCGTGC
ACGCTAGTATCGTAGTCCA: CGCTAGTATCGTAGTCCAC
ACGCTTTAGCAGTGTAAAG: CGCTTTAGCAGTGTAAAGA
ACGGCACAGCGCCCGGGCC: CGGCACAGCGCCCGGGCCA
ACGGCACTATTTGCACACG: CGGCACTATTTGCACACGG
ACGGCCGAAACAGTTTGAC: CGGCCGAAACAGTTTGACC
ACGGCGGGCACTTATGCCG: CGGCGGGCACTTATGCCGA
ACGGCTTGGGCCACGGTAA: CGGCTTGGGCCACGGTAAG
ACGGGCGGGCTTAAGCTGT: CGGGCGGGCTTAAGCTGTA
ACGGTAAGACTTGGAAATC: CGGTAAGACTTGGAAATCC
ACGGTCTAAGCGCCTGCCA: CGGTCTAAGCGCCTGCCAC
ACGGTTATGCCCACCCGCA: CGGTTATGCCCACCCGCAT
ACGGTTCCTAGATCAGTGG: CGGTTCCTAGATCAGTGGT
ACGGTTGTTGGGGCTGACC: CGGTTGTTGGGGCTGACCC
ACGTAACGATAGCGAAGCC: CGTAACGATAGCGAAGCCG
ACGTAAGGGTAGAGTATAC: CGTAAGGGTAGAGTATACC
ACGTCATCTTCCCACCTTT: CGTCATCTTCCCACCTTTA
ACGTCCAACATCACGACAT: CGTCCAACATCACGACATG
ACGTGCGAGTTTCTTTAAC: CGTGCGAGTTTCTTTAACG
ACTAATAGGGTTGTAACGT: CTAATAGGGTTGTAACGTA
ACTACTTGCACGTCATCTT: CTACTTGCACGTCATCTTC
ACTATTAACTCGCAGATCT: CTATTAACTCGCAGATCTC
ACTATTTACGGTTATGCCC: CTATTTACGGTTATGCCCA
ACTATTTGCACACGGCTTG: CTATTTGCACACGGCTTGG
ACTCACTTCCTGTATGTAA: CTCACTTCCTGTATGTAAG
ACTCATTAAGCGGACCATC: CTCATTAAGCGGACCATCT
ACTCGCAGATCTCATATCG: CTCGCAGATCTCATATCGG
ACTCGCAGATCTCCTGTAT: CTCGCAGATCTCCTGTATG
ACTCGCAGATCTCGGCAGA: CTCGCAGATCTCGGCAGAA
ACTCGCAGATCTCTACGGT: CTCGCAGATCTCTACGGTT
ACTCGTCCATATGGCCAGC: CTCGTCCATATGGCCAGCA
ACTCGTGAGTATAACACCC: CTCGTGAGTATAACACCCA
ACTCTGTAAACGGTCTAAG: CTCTGTAAACGGTCTAAGC
ACTGCACGGCACAGCGCCC: CTGCACGGCACAGCGCCCG
ACTGCCCCACACTGCACGG: CTGCCCCACACTGCACGGC
ACTGCGCCGCTGTATTCAA: CTGCGCCGCTGTATTCAAT
ACTGCGGGCGGGTCATCTG: CTGCGGGCGGGTCATCTGA
ACTGGAGTTTAGAGGAAGA: CTGGAGTTTAGAGGAAGAA
ACTGGCGGGAAATACATGG: CTGGCGGGAAATACATGGC
ACTGTAATCGGCGTTTATC: CTGTAATCGGCGTTTATCA
ACTGTGAGCGCTGATGTCG: CTGTGAGCGCTGATGTCGT
ACTTATACACGCCAATTTG: CTTATACACGCCAATTTGA
ACTTATGCCGACTAATAGG: CTTATGCCGACTAATAGGG
ACTTCAAAGGCCTGCGCCA: CTTCAAAGGCCTGCGCCAA
ACTTCAACAATTCTCGCCT: CTTCAACAATTCTCGCCTA
ACTTCCAGCCTCAGTTACG: CTTCCAGCCTCAGTTACGG
ACTTCCTGTATGTAAGTCG: CTTCCTGTATGTAAGTCGG
ACTTGCACGTCATCTTCCC: CTTGCACGTCATCTTCCCA
ACTTGGAAATCCTCTTCAC: CTTGGAAATCCTCTTCACG
ACTTGGAGGCAATGATGTG: CTTGGAGGCAATGATGTGA
ACTTGTCGATAGGCGGACG: CTTGTCGATAGGCGGACGC
ACTTTAATTAGATGGTATT: CTTTAATTAGATGGTATTC
AGAAAGGCTCGGCTAATCG: GAAAGGCTCGGCTAATCGC
AGAACAGAACGCAATAACT: GAACAGAACGCAATAACTG
AGAACATAGATCAGTGGTC: GAACATAGATCAGTGGTCG
AGAACCCTCATTTTATCTC: GAACCCTCATTTTATCTCA
AGAACGCAATAACTGGAGT: GAACGCAATAACTGGAGTT
AGAACTGCCCCACACTGCA: GAACTGCCCCACACTGCAC
AGAATCTATCGTGTACATT: GAATCTATCGTGTACATTC
AGACAAAAGAGGGGGACCC: GACAAAAGAGGGGGACCCT
AGACATTATCAACTATTAA: GACATTATCAACTATTAAC
AGACGCGTAAATATACGCA: GACGCGTAAATATACGCAC
AGACGCTAGTATCGTAGTC: GACGCTAGTATCGTAGTCC
AGACTGCGGGCGGGTCATC: GACTGCGGGCGGGTCATCT
AGACTTGGAAATCCTCTTC: GACTTGGAAATCCTCTTCA
AGAGCGGGTGATTCTGGTC: GAGCGGGTGATTCTGGTCT
AGAGGAAGAAAGGCTCGGC: GAGGAAGAAAGGCTCGGCT
AGAGGGGGACCCTTCATAC: GAGGGGGACCCTTCATACA
AGAGTATACCTACAGAACA: GAGTATACCTACAGAACAG
AGAGTGAGGGCCGCGGCGG: GAGTGAGGGCCGCGGCGGG
AGAGTGGATAAAAGCAAAC: GAGTGGATAAAAGCAAACC
AGATACTGTGAGCGCTGAT: GATACTGTGAGCGCTGATG
AGATCAGTGGTCGAGCATG: GATCAGTGGTCGAGCATGA GATCAGTGGTCGAGCATGA
AGATCTAGTTTTACTCTGT: GATCTAGTTTTACTCTGTA
AGATCTCATATCGGTTGCG: GATCTCATATCGGTTGCGA
AGATCTCCTGTATGACCCG: GATCTCCTGTATGACCCGA
AGATCTCGGCAGAACATAG: GATCTCGGCAGAACATAGA
AGATCTCTACGGTTCCTAG: GATCTCTACGGTTCCTAGA
AGATGACTCATTAAGCGGA: GATGACTCATTAAGCGGAC
AGATGGTATTCCAAACTTA: GATGGTATTCCAAACTTAA
AGCAAACCCGTACAAGACA: GCAAACCCGTACAAGACAA
AGCAGTGTAAAGAGTGGAT: GCAGTGTAAAGAGTGGATA
AGCATAAATATTAACTCGC: GCATAAATATTAACTCGCA
AGCATCCTTTCGTGTGACC: GCATCCTTTCGTGTGACCA
AGCATGAAAGGCCAGCCGG: GCATGAAAGGCCAGCCGGT
AGCATGACGGTTGTTGGGG: GCATGACGGTTGTTGGGGC
AGCATGAGATGACTCATTA: GCATGAGATGACTCATTAA
AGCATGAGCCGAACTTTAA: GCATGAGCCGAACTTTAAT
AGCATGGAATTCGAGTCCC: GCATGGAATTCGAGTCCCT
AGCATGTCCCGACACATAT: GCATGTCCCGACACATATT
AGCCAAGCATGGAATTCGA: GCCAAGCATGGAATTCGAG
AGCCAGCCAAGCATGGAAT: GCCAGCCAAGCATGGAATT
AGCCGAACTTTAATTAGAT: GCCGAACTTTAATTAGATG
AGCCGCCCTCACACTTCAA: GCCGCCCTCACACTTCAAA
AGCCGGTCAACTTGTCGAT: GCCGGTCAACTTGTCGATA
AGCCTAACGGGCGGGCTTA: GCCTAACGGGCGGGCTTAA
AGCCTACTACTTGCACGTC: GCCTACTACTTGCACGTCA
AGCCTCAGTTACGGCACTA: GCCTCAGTTACGGCACTAT
AGCGAACCCTAGGGGAAGT: GCGAACCCTAGGGGAAGTC
AGCGAAGCCGCCCTCACAC: GCGAAGCCGCCCTCACACT
AGCGACGTAAGGGTAGAGT: GCGACGTAAGGGTAGAGTA
AGCGCCCGGGCCATTAATT: GCGCCCGGGCCATTAATTT
AGCGCCTGCCACCAACGCC: GCGCCTGCCACCAACGCCT
AGCGCTGATGTCGTTCGAA: GCGCTGATGTCGTTCGAAA
AGCGGACCATCTTTCCCGC: GCGGACCATCTTTCCCGCA
AGCGGGTGATTCTGGTCTT: GCGGGTGATTCTGGTCTTT
AGCGTCACCCGGACGCCCA: GCGTCACCCGGACGCCCAT
AGCGTTCGGACGCATTGAG: GCGTTCGGACGCATTGAGT
AGCTAGACGCGTAAATATA: GCTAGACGCGTAAATATAC
AGCTAGCTAGGGGATCCTC: GCTAGCTAGGGGATCCTCT
AGCTAGGGGATCCTCTCGG: GCTAGGGGATCCTCTCGGG
AGCTCCCTTATGGACGAGC: GCTCCCTTATGGACGAGCC
AGCTCCTAATTGCTGTCAT: GCTCCTAATTGCTGTCATG
AGCTGACCGCGGCATACCC: GCTGACCGCGGCATACCCG
AGCTGCCATCCCGGCTGAC: GCTGCCATCCCGGCTGACA
AGCTGCCTTTGGGATACTT: GCTGCCTTTGGGATACTTC
AGCTGTAACAGGCTAGATA: GCTGTAACAGGCTAGATAC
AGGAAGAAAGGCTCGGCTA: GGAAGAAAGGCTCGGCTAA
AGGATAGTGACGCTTTAGC: GGATAGTGACGCTTTAGCA
AGGATCTGACAGCTGACCG: GGATCTGACAGCTGACCGC
AGGCAATGATGTGACGAAT: GGCAATGATGTGACGAATG
AGGCATCCGCACCGTAGTC: GGCATCCGCACCGTAGTCA
AGGCCAGCCGGTCAACTTG: GGCCAGCCGGTCAACTTGT
AGGCCCAATAAATTAGACT: GGCCCAATAAATTAGACTG
AGGCCGCTCTCGCGATCGC: GGCCGCTCTCGCGATCGCG
AGGCCTGCGCCAAGCTGCC: GGCCTGCGCCAAGCTGCCA
AGGCGGACGCGTCGGCCAT: GGCGGACGCGTCGGCCATA
AGGCTAGATACTGTGAGCG: GGCTAGATACTGTGAGCGC
AGGCTCGGCTAATCGCGCC: GGCTCGGCTAATCGCGCCC
AGGCTGAACTGGCGGGAAA: GGCTGAACTGGCGGGAAAT
AGGGCCGCGGCGGGTGCCG: GGGCCGCGGCGGGTGCCGA
AGGGCTGTTGTGACCCTTA: GGGCTGTTGTGACCCTTAT
AGGGGAAGTCCCAGCATGT: GGGGAAGTCCCAGCATGTC
AGGGGATCCTCTCGGGAGC: GGGGATCCTCTCGGGAGCT
AGGGGCTTGACGTGCGAGT: GGGGCTTGACGTGCGAGTT
AGGGGGACCCTTCATACAT: GGGGGACCCTTCATACATC
AGGGTAGAGTATACCTACA: GGGTAGAGTATACCTACAG
AGGGTTGTAACGTAACGAT: GGGTTGTAACGTAACGATA
AGGTGAGACATTATCAACT: GGTGAGACATTATCAACTA
AGGTGGATCTCCTCTTGGT: GGTGGATCTCCTCTTGGTG
AGGTGTGACTGTAATCGGC: GGTGTGACTGTAATCGGCG
AGTACCTGTTGCTTTCAGG: GTACCTGTTGCTTTCAGGC
AGTAGAACCCTCATTTTAT: GTAGAACCCTCATTTTATC
AGTAGAGCGGGTGATTCTG: GTAGAGCGGGTGATTCTGG
AGTATAACACCCAATATCT: GTATAACACCCAATATCTG
AGTATACCTACAGAACAGA: GTATACCTACAGAACAGAA
AGTATCGTAGTCCACCATA: GTATCGTAGTCCACCATAA
AGTCAGTGACATATTATCG: GTCAGTGACATATTATCGC
AGTCCACCATAATCTTCCA: GTCCACCATAATCTTCCAA
AGTCCCAGCATGTCCCGAC: GTCCCAGCATGTCCCGACA
AGTCCCTGCGGCTACTCAC: GTCCCTGCGGCTACTCACT
AGTCGGGTATCATTGCAGG: GTCGGGTATCATTGCAGGT
AGTGAAGGCCGCTCTCGCG: GTGAAGGCCGCTCTCGCGA
AGTGACATATTATCGCTAG: GTGACATATTATCGCTAGG
AGTGACGCTTTAGCAGTGT: GTGACGCTTTAGCAGTGTA
AGTGAGGGCCGCGGCGGGT: GTGAGGGCCGCGGCGGGTG
AGTGGATAAAAGCAAACCC: GTGGATAAAAGCAAACCCG
AGTGGTCGAGCATGAAAGG: GTGGTCGAGCATGAAAGGC
AGTGGTCGAGCATGACGGT: GTGGTCGAGCATGACGGTT
AGTGGTCGAGCATGAGATG: GTGGTCGAGCATGAGATGA
AGTGGTCGAGCATGAGCCG: GTGGTCGAGCATGAGCCGA
AGTGTAAAGAGTGGATAAA: GTGTAAAGAGTGGATAAAA
AGTGTACACACGAATCTGA: GTGTACACACGAATCTGAA
AGTTACGGCACTATTTGCA: GTTACGGCACTATTTGCAC
AGTTATAGCTCCCTTATGG: GTTATAGCTCCCTTATGGA
AGTTCTCTATTCGTGCGTG: GTTCTCTATTCGTGCGTGG
AGTTTAGAGGAAGAAAGGC: GTTTAGAGGAAGAAAGGCT
AGTTTCTTTAACGGCCGAA: GTTTCTTTAACGGCCGAAA
AGTTTGACCGACTCGTCCA: GTTTGACCGACTCGTCCAT
AGTTTGAGTGAAGGCCGCT: GTTTGAGTGAAGGCCGCTC
AGTTTTACTCTGTAAACGG: GTTTTACTCTGTAAACGGT
ATAAAAGCAAACCCGTACA: TAAAAGCAAACCCGTACAA
ATAAACATCGGGGCGGGAA: TAAACATCGGGGCGGGAAC
ATAAATATTAACTCGCAGA: TAAATATTAACTCGCAGAT
ATAAATTAGACTGCGGGCG: TAAATTAGACTGCGGGCGG
ATAACACCCAATATCTGAC: TAACACCCAATATCTGACG
ATAACTATTTACGGTTATG: TAACTATTTACGGTTATGC
ATAACTGGAGTTTAGAGGA: TAACTGGAGTTTAGAGGAA
ATAAGAATCTATCGTGTAC: TAAGAATCTATCGTGTACA
ATAAGTTTGAGTGAAGGCC: TAAGTTTGAGTGAAGGCCG
ATAATACAGTGTACACACG: TAATACAGTGTACACACGA
ATAATCTTCCAACATTTAC: TAATCTTCCAACATTTACA
ATAATTAATAAGAATCTAT: TAATTAATAAGAATCTATC
ATAATTAGCCTACTACTTG: TAATTAGCCTACTACTTGC
ATACACCGTGGGATCCGTG: TACACCGTGGGATCCGTGT
ATACACGCCAATTTGAGCG: TACACGCCAATTTGAGCGA
ATACAGTGTACACACGAAT: TACAGTGTACACACGAATC
ATACATCAACAAGCTAGAC: TACATCAACAAGCTAGACG
ATACATCTATCCTGTGCAA: TACATCTATCCTGTGCAAA
ATACATGGCGCATCGCGAT: TACATGGCGCATCGCGATA
ATACCCGAGGGCTGTTGTG: TACCCGAGGGCTGTTGTGA
ATACCTACAGAACAGAACG: TACCTACAGAACAGAACGC
ATACGCACAATACACCGTG: TACGCACAATACACCGTGG
ATACTGTGAGCGCTGATGT: TACTGTGAGCGCTGATGTC
ATACTTCCAGCCTCAGTTA: TACTTCCAGCCTCAGTTAC
ATAGATCAGTGGTCGAGCA: TAGATCAGTGGTCGAGCAT
ATAGCGAAGCCGCCCTCAC: TAGCGAAGCCGCCCTCACA
ATAGCTCCCTTATGGACGA: TAGCTCCCTTATGGACGAG
ATAGGCCCAATAAATTAGA: TAGGCCCAATAAATTAGAC
ATAGGCGGACGCGTCGGCC: TAGGCGGACGCGTCGGCCA
ATAGGGTTGTAACGTAACG: TAGGGTTGTAACGTAACGA
ATAGTGACGCTTTAGCAGT: TAGTGACGCTTTAGCAGTG
ATATACGCACAATACACCG: TATACGCACAATACACCGT
ATATAGGCCCAATAAATTA: TATAGGCCCAATAAATTAG
ATATCATATCGGAACGAAG: TATCATATCGGAACGAAGT
ATATCCGACCACAGAGTGA: TATCCGACCACAGAGTGAG
ATATCGGAACGAAGTAGAG: TATCGGAACGAAGTAGAGC
ATATCGGTTGCGATCAGTG: TATCGGTTGCGATCAGTGG
ATATCGTGCTTATAACTAT: TATCGTGCTTATAACTATT
ATATCTGACGGCGGGCACT: TATCTGACGGCGGGCACTT
ATATGGCCAGCATCCTTTC: TATGGCCAGCATCCTTTCG
ATATGGTAGGTGTGACTGT: TATGGTAGGTGTGACTGTA
ATATTAACTCGCAGATCTC: TATTAACTCGCAGATCTCA
ATATTACGCGGTCGCGTAT: TATTACGCGGTCGCGTATA
ATATTATCGCTAGGATAGT: TATTATCGCTAGGATAGTG
ATATTCGGGAGCCTAACGG: TATTCGGGAGCCTAACGGG
ATATTGTCGCTAGCGTCAC: TATTGTCGCTAGCGTCACC
ATCAACAAGCTAGACGCGT: TCAACAAGCTAGACGCGTA
ATCAACTATTAACTCGCAG: TCAACTATTAACTCGCAGA
ATCACGACATGAATGCTCT: TCACGACATGAATGCTCTT
ATCACGCATACATCTATCC: TCACGCATACATCTATCCT
ATCAGTGGTCGAGCATGAA: TCAGTGGTCGAGCATGAAA
ATCAGTGGTCGAGCATGAC: TCAGTGGTCGAGCATGACG
ATCAGTGGTCGAGCATGAG: TCAGTGGTCGAGCATGAGA TCAGTGGTCGAGCATGAGC
ATCATAATTAGCCTACTAC: TCATAATTAGCCTACTACT
ATCATATCGGAACGAAGTA: TCATATCGGAACGAAGTAG
ATCATTGCAGGTGAGACAT: TCATTGCAGGTGAGACATT
ATCCAATTGACGCCCTTTG: TCCAATTGACGCCCTTTGA
ATCCCGGCTGACAGCTGCC: TCCCGGCTGACAGCTGCCT
ATCCGACCACAGAGTGAGG: TCCGACCACAGAGTGAGGG
ATCCGCACCGTAGTCAGTG: TCCGCACCGTAGTCAGTGA
ATCCGTGTCAACTGCGCCG: TCCGTGTCAACTGCGCCGC
ATCCGTGTCTATATTCGGG: TCCGTGTCTATATTCGGGA
ATCCTCTCGGGAGCTCCTA: TCCTCTCGGGAGCTCCTAA
ATCCTCTTCACGCACATCA: TCCTCTTCACGCACATCAC
ATCCTGGAAACTTGGAGGC: TCCTGGAAACTTGGAGGCA
ATCCTGTGCAAAGCTAGCT: TCCTGTGCAAAGCTAGCTA
ATCCTTTCGTGTGACCATA: TCCTTTCGTGTGACCATAT
ATCGATATGGTAGGTGTGA: TCGATATGGTAGGTGTGAC
ATCGCATGCTTGCGCTGTG: TCGCATGCTTGCGCTGTGA
ATCGCGATAAACATCGGGG: TCGCGATAAACATCGGGGC
ATCGCGCCCGTTATAATTA: TCGCGCCCGTTATAATTAA
ATCGCGTAGGATCTGACAG: TCGCGTAGGATCTGACAGC
ATCGCTAGGATAGTGACGC: TCGCTAGGATAGTGACGCT
ATCGGAACGAAGTAGAGCG: TCGGAACGAAGTAGAGCGG
ATCGGCGTTTATCATAATT: TCGGCGTTTATCATAATTA
ATCGGGGCGGGAACCTGCT: TCGGGGCGGGAACCTGCTC
ATCGGTTGCGATCAGTGGT: TCGGTTGCGATCAGTGGTC
ATCGTAGTCCACCATAATC: TCGTAGTCCACCATAATCT
ATCGTGCTTATAACTATTT: TCGTGCTTATAACTATTTA
ATCGTGTACATTCACAAGC: TCGTGTACATTCACAAGCG
ATCTAGTTTTACTCTGTAA: TCTAGTTTTACTCTGTAAA
ATCTATCCTGTGCAAAGCT: TCTATCCTGTGCAAAGCTA
ATCTATCGTGTACATTCAC: TCTATCGTGTACATTCACA
ATCTCATATCCGACCACAG: TCTCATATCCGACCACAGA
ATCTCATATCGGTTGCGAT: TCTCATATCGGTTGCGATC
ATCTCCTCTTGGTGCGTGA: TCTCCTCTTGGTGCGTGAA
ATCTCCTGTATGACCCGAT: TCTCCTGTATGACCCGATC
ATCTCGGCAGAACATAGAT: TCTCGGCAGAACATAGATC
ATCTCTACGGTTCCTAGAT: TCTCTACGGTTCCTAGATC
ATCTGAATGGGATTATCGA: TCTGAATGGGATTATCGAT
ATCTGACAATTCTAGGCAT: TCTGACAATTCTAGGCATC
ATCTGACAGCTGACCGCGG: TCTGACAGCTGACCGCGGC
ATCTGACGGCGGGCACTTA: TCTGACGGCGGGCACTTAT
ATCTTCCAACATTTACAGA: TCTTCCAACATTTACAGAT
ATCTTCCCACCTTTATCCA: TCTTCCCACCTTTATCCAA
ATCTTTCCCGCACGTCCAA: TCTTTCCCGCACGTCCAAC
ATGAAAGGCCAGCCGGTCA: TGAAAGGCCAGCCGGTCAA
ATGAATGCTCTTGAGAACT: TGAATGCTCTTGAGAACTG
ATGACCCGATCAGTGGTCG: TGACCCGATCAGTGGTCGA
ATGACGGTTGTTGGGGCTG: TGACGGTTGTTGGGGCTGA
ATGACTCATTAAGCGGACC: TGACTCATTAAGCGGACCA
ATGAGATGACTCATTAAGC: TGAGATGACTCATTAAGCG
ATGAGCCGAACTTTAATTA: TGAGCCGAACTTTAATTAG
ATGATGTGACGAATGCCTT: TGATGTGACGAATGCCTTT
ATGATTCTCGGTCAAAACT: TGATTCTCGGTCAAAACTT
ATGCCCACCCGCATCCGTG: TGCCCACCCGCATCCGTGT
ATGCCGACTAATAGGGTTG: TGCCGACTAATAGGGTTGT
ATGCCTTTGCCATTGCCGA: TGCCTTTGCCATTGCCGAC
ATGCGAGTTCTCTATTCGT: TGCGAGTTCTCTATTCGTG
ATGCTCAAGGGGCTTGACG: TGCTCAAGGGGCTTGACGT
ATGCTCTAATAATACAGTG: TGCTCTAATAATACAGTGT
ATGCTCTTGAGAACTGCCC: TGCTCTTGAGAACTGCCCC
ATGCTTGCGCTGTGACCAG: TGCTTGCGCTGTGACCAGT
ATGGAATTCGAGTCCCTGC: TGGAATTCGAGTCCCTGCG
ATGGACGAGCCAGCCAAGC: TGGACGAGCCAGCCAAGCA
ATGGCCAGCATCCTTTCGT: TGGCCAGCATCCTTTCGTG
ATGGCCGCGCTGTTATGCT: TGGCCGCGCTGTTATGCTC
ATGGCGCATCGCGATAAAC: TGGCGCATCGCGATAAACA
ATGGGATTATCGATATGGT: TGGGATTATCGATATGGTA
ATGGTAGGTGTGACTGTAA: TGGTAGGTGTGACTGTAAT
ATGGTATTCCAAACTTAAA: TGGTATTCCAAACTTAAAC
ATGTAAGTCGGGTATCATT: TGTAAGTCGGGTATCATTG
ATGTCCCGACACATATTGT: TGTCCCGACACATATTGTC
ATGTCGTTCGAAAGCATAA: TGTCGTTCGAAAGCATAAA
ATGTGACGAATGCCTTTGC: TGTGACGAATGCCTTTGCC
ATGTGATCCTGGAAACTTG: TGTGATCCTGGAAACTTGG
ATTAACTCGCAGATCTCAT: TTAACTCGCAGATCTCATA
ATTAACTCGCAGATCTCCT: TTAACTCGCAGATCTCCTG
ATTAACTCGCAGATCTCGG: TTAACTCGCAGATCTCGGC
ATTAACTCGCAGATCTCTA: TTAACTCGCAGATCTCTAC
ATTAAGCGGACCATCTTTC: TTAAGCGGACCATCTTTCC
ATTAATAAGAATCTATCGT: TTAATAAGAATCTATCGTG
ATTAATTTCGGGGTCGGGT: TTAATTTCGGGGTCGGGTC
ATTACGCGGTCGCGTATAT: TTACGCGGTCGCGTATATA
ATTAGACTGCGGGCGGGTC: TTAGACTGCGGGCGGGTCA
ATTAGATGGTATTCCAAAC: TTAGATGGTATTCCAAACT
ATTAGCCTACTACTTGCAC: TTAGCCTACTACTTGCACG
ATTATCAACTATTAACTCG: TTATCAACTATTAACTCGC
ATTATCGATATGGTAGGTG: TTATCGATATGGTAGGTGT
ATTATCGCTAGGATAGTGA: TTATCGCTAGGATAGTGAC
ATTCAATGATTCTCGGTCA: TTCAATGATTCTCGGTCAA
ATTCACAAGCGTTCGGACG: TTCACAAGCGTTCGGACGC
ATTCGAGTCCCTGCGGCTA: TTCGAGTCCCTGCGGCTAC
ATTCGGGAGCCTAACGGGC: TTCGGGAGCCTAACGGGCG
ATTCGTGCGTGGTCGGTCC: TTCGTGCGTGGTCGGTCCG
ATTCTAGGCATCCGCACCG: TTCTAGGCATCCGCACCGT
ATTCTCGCCTACCCCACTC: TTCTCGCCTACCCCACTCG
ATTCTCGGTCAAAACTTAT: TTCTCGGTCAAAACTTATA
ATTCTGGTCTTTATAAGTT: TTCTGGTCTTTATAAGTTT
ATTGACGCCCTTTGATGCT: TTGACGCCCTTTGATGCTC
ATTGAGTACCTGTTGCTTT: TTGAGTACCTGTTGCTTTC
ATTGATGTGATCCTGGAAA: TTGATGTGATCCTGGAAAC
ATTGCAGGTGAGACATTAT: TTGCAGGTGAGACATTATC
ATTGCCGACTTCAACAATT: TTGCCGACTTCAACAATTC
ATTGCTGTCATGCGAGTTC: TTGCTGTCATGCGAGTTCT
ATTGTCGCTAGCGTCACCC: TTGTCGCTAGCGTCACCCG
ATTTACAGATCTAGTTTTA: TTTACAGATCTAGTTTTAC
ATTTACGGTTATGCCCACC: TTTACGGTTATGCCCACCC
ATTTCGGGGTCGGGTCCCG: TTTCGGGGTCGGGTCCCGG
ATTTGAGCGACGTAAGGGT: TTTGAGCGACGTAAGGGTA
ATTTGCACACGGCTTGGGC: TTTGCACACGGCTTGGGCC
ATTTTATCTCATATCCGAC: TTTTATCTCATATCCGACC
CAAAACTTATACACGCCAA: AAAACTTATACACGCCAAT
CAAAAGAGGGGGACCCTTC: AAAAGAGGGGGACCCTTCA
CAAACCCGTACAAGACAAA: AAACCCGTACAAGACAAAA
CAAAGCTAGCTAGGGGATC: AAAGCTAGCTAGGGGATCC
CAAAGGCCTGCGCCAAGCT: AAAGGCCTGCGCCAAGCTG
CAACAAGCTAGACGCGTAA: AACAAGCTAGACGCGTAAA
CAACAATTCTCGCCTACCC: AACAATTCTCGCCTACCCC
CAACATCACGACATGAATG: AACATCACGACATGAATGC
CAACATTTACAGATCTAGT: AACATTTACAGATCTAGTT
CAACGCCTGTTATTAACTC: AACGCCTGTTATTAACTCG
CAACTATTAACTCGCAGAT: AACTATTAACTCGCAGATC
CAACTGCGCCGCTGTATTC: AACTGCGCCGCTGTATTCA
CAACTTGTCGATAGGCGGA: AACTTGTCGATAGGCGGAC
CAAGACAAAAGAGGGGGAC: AAGACAAAAGAGGGGGACC
CAAGCATGGAATTCGAGTC: AAGCATGGAATTCGAGTCC
CAAGCGTTCGGACGCATTG: AAGCGTTCGGACGCATTGA
CAAGCTAGACGCGTAAATA: AAGCTAGACGCGTAAATAT
CAAGCTGCCATCCCGGCTG: AAGCTGCCATCCCGGCTGA
CAAGGGGCTTGACGTGCGA: AAGGGGCTTGACGTGCGAG
CAATAAATTAGACTGCGGG: AATAAATTAGACTGCGGGC
CAATAACTGGAGTTTAGAG: AATAACTGGAGTTTAGAGG
CAATACACCGTGGGATCCG: AATACACCGTGGGATCCGT
CAATATCTGACGGCGGGCA: AATATCTGACGGCGGGCAC
CAATGATGTGACGAATGCC: AATGATGTGACGAATGCCT
CAATGATTCTCGGTCAAAA: AATGATTCTCGGTCAAAAC
CAATGGCCGCGCTGTTATG: AATGGCCGCGCTGTTATGC
CAATTCTAGGCATCCGCAC: AATTCTAGGCATCCGCACC
CAATTCTCGCCTACCCCAC: AATTCTCGCCTACCCCACT
CAATTGACGCCCTTTGATG: AATTGACGCCCTTTGATGC
CAATTTGAGCGACGTAAGG: AATTTGAGCGACGTAAGGG
CACAAGCGTTCGGACGCAT: ACAAGCGTTCGGACGCATT
CACAATACACCGTGGGATC: ACAATACACCGTGGGATCC
CACACGAATCTGAATGGGA: ACACGAATCTGAATGGGAT
CACACGGCTTGGGCCACGG: ACACGGCTTGGGCCACGGT
CACACTGCACGGCACAGCG: ACACTGCACGGCACAGCGC
CACACTTCAAAGGCCTGCG: ACACTTCAAAGGCCTGCGC
CACAGAGTGAGGGCCGCGG: ACAGAGTGAGGGCCGCGGC
CACAGCGCCCGGGCCATTA: ACAGCGCCCGGGCCATTAA
CACATATTGTCGCTAGCGT: ACATATTGTCGCTAGCGTC
CACATCACGCATACATCTA: ACATCACGCATACATCTAT
CACCAACGCCTGTTATTAA: ACCAACGCCTGTTATTAAC
CACCATAATCTTCCAACAT: ACCATAATCTTCCAACATT
CACCCAATATCTGACGGCG: ACCCAATATCTGACGGCGG
CACCCGCATCCGTGTCAAC: ACCCGCATCCGTGTCAACT
CACCCGGACGCCCATTGAT: ACCCGGACGCCCATTGATG
CACCGTAGTCAGTGACATA: ACCGTAGTCAGTGACATAT
CACCGTGGGATCCGTGTCT: ACCGTGGGATCCGTGTCTA
CACCTTTATCCAATTGACG: ACCTTTATCCAATTGACGC
CACGAATCTGAATGGGATT: ACGAATCTGAATGGGATTA
CACGACATGAATGCTCTTG: ACGACATGAATGCTCTTGA
CACGCACATCACGCATACA: ACGCACATCACGCATACAT
CACGCATACATCTATCCTG: ACGCATACATCTATCCTGT
CACGCCAATTTGAGCGACG: ACGCCAATTTGAGCGACGT
CACGGCACAGCGCCCGGGC: ACGGCACAGCGCCCGGGCC
CACGGCTTGGGCCACGGTA: ACGGCTTGGGCCACGGTAA
CACGGTAAGACTTGGAAAT: ACGGTAAGACTTGGAAATC
CACGTCATCTTCCCACCTT: ACGTCATCTTCCCACCTTT
CACGTCCAACATCACGACA: ACGTCCAACATCACGACAT
CACTATTTGCACACGGCTT: ACTATTTGCACACGGCTTG
CACTCGTGAGTATAACACC: ACTCGTGAGTATAACACCC
CACTGCACGGCACAGCGCC: ACTGCACGGCACAGCGCCC
CACTTATGCCGACTAATAG: ACTTATGCCGACTAATAGG
CACTTCAAAGGCCTGCGCC: ACTTCAAAGGCCTGCGCCA
CACTTCCTGTATGTAAGTC: ACTTCCTGTATGTAAGTCG
CAGAACAGAACGCAATAAC: AGAACAGAACGCAATAACT
CAGAACATAGATCAGTGGT: AGAACATAGATCAGTGGTC
CAGAACGCAATAACTGGAG: AGAACGCAATAACTGGAGT
CAGAGTGAGGGCCGCGGCG: AGAGTGAGGGCCGCGGCGG
CAGATCTAGTTTTACTCTG: AGATCTAGTTTTACTCTGT
CAGATCTCATATCGGTTGC: AGATCTCATATCGGTTGCG
CAGATCTCCTGTATGACCC: AGATCTCCTGTATGACCCG
CAGATCTCGGCAGAACATA: AGATCTCGGCAGAACATAG
CAGATCTCTACGGTTCCTA: AGATCTCTACGGTTCCTAG
CAGCATCCTTTCGTGTGAC: AGCATCCTTTCGTGTGACC
CAGCATGTCCCGACACATA: AGCATGTCCCGACACATAT
CAGCCAAGCATGGAATTCG: AGCCAAGCATGGAATTCGA
CAGCCGGTCAACTTGTCGA: AGCCGGTCAACTTGTCGAT
CAGCCTCAGTTACGGCACT: AGCCTCAGTTACGGCACTA
CAGCGCCCGGGCCATTAAT: AGCGCCCGGGCCATTAATT
CAGCTGACCGCGGCATACC: AGCTGACCGCGGCATACCC
CAGCTGCCTTTGGGATACT: AGCTGCCTTTGGGATACTT
CAGGCTAGATACTGTGAGC: AGGCTAGATACTGTGAGCG
CAGGCTGAACTGGCGGGAA: AGGCTGAACTGGCGGGAAA
CAGGTGAGACATTATCAAC: AGGTGAGACATTATCAACT
CAGTGACATATTATCGCTA: AGTGACATATTATCGCTAG
CAGTGGTCGAGCATGAAAG: AGTGGTCGAGCATGAAAGG
CAGTGGTCGAGCATGACGG: AGTGGTCGAGCATGACGGT
CAGTGGTCGAGCATGAGAT: AGTGGTCGAGCATGAGATG
CAGTGGTCGAGCATGAGCC: AGTGGTCGAGCATGAGCCG
CAGTGTAAAGAGTGGATAA: AGTGTAAAGAGTGGATAAA
CAGTGTACACACGAATCTG: AGTGTACACACGAATCTGA
CAGTTACGGCACTATTTGC: AGTTACGGCACTATTTGCA
CAGTTATAGCTCCCTTATG: AGTTATAGCTCCCTTATGG
CAGTTTGACCGACTCGTCC: AGTTTGACCGACTCGTCCA
CATAAATATTAACTCGCAG: ATAAATATTAACTCGCAGA
CATAATCTTCCAACATTTA: ATAATCTTCCAACATTTAC
CATAATTAGCCTACTACTT: ATAATTAGCCTACTACTTG
CATACATCAACAAGCTAGA: ATACATCAACAAGCTAGAC
CATACATCTATCCTGTGCA: ATACATCTATCCTGTGCAA
CATACCCGAGGGCTGTTGT: ATACCCGAGGGCTGTTGTG
CATAGATCAGTGGTCGAGC: ATAGATCAGTGGTCGAGCA
CATATCCGACCACAGAGTG: ATATCCGACCACAGAGTGA
CATATCGGAACGAAGTAGA: ATATCGGAACGAAGTAGAG
CATATCGGTTGCGATCAGT: ATATCGGTTGCGATCAGTG
CATATCGTGCTTATAACTA: ATATCGTGCTTATAACTAT
CATATGGCCAGCATCCTTT: ATATGGCCAGCATCCTTTC
CATATTACGCGGTCGCGTA: ATATTACGCGGTCGCGTAT
CATATTATCGCTAGGATAG: ATATTATCGCTAGGATAGT
CATATTGTCGCTAGCGTCA: ATATTGTCGCTAGCGTCAC
CATCAACAAGCTAGACGCG: ATCAACAAGCTAGACGCGT
CATCACGACATGAATGCTC: ATCACGACATGAATGCTCT
CATCACGCATACATCTATC: ATCACGCATACATCTATCC
CATCCCGGCTGACAGCTGC: ATCCCGGCTGACAGCTGCC
CATCCGCACCGTAGTCAGT: ATCCGCACCGTAGTCAGTG
CATCCGTGTCAACTGCGCC: ATCCGTGTCAACTGCGCCG
CATCCTTTCGTGTGACCAT: ATCCTTTCGTGTGACCATA
CATCGCGATAAACATCGGG: ATCGCGATAAACATCGGGG
CATCGGGGCGGGAACCTGC: ATCGGGGCGGGAACCTGCT
CATCTATCCTGTGCAAAGC: ATCTATCCTGTGCAAAGCT
CATCTGACAATTCTAGGCA: ATCTGACAATTCTAGGCAT
CATCTTCCCACCTTTATCC: ATCTTCCCACCTTTATCCA
CATCTTTCCCGCACGTCCA: ATCTTTCCCGCACGTCCAA
CATGAAAGGCCAGCCGGTC: ATGAAAGGCCAGCCGGTCA
CATGAATGCTCTTGAGAAC: ATGAATGCTCTTGAGAACT
CATGACGGTTGTTGGGGCT: ATGACGGTTGTTGGGGCTG
CATGAGATGACTCATTAAG: ATGAGATGACTCATTAAGC
CATGAGCCGAACTTTAATT: ATGAGCCGAACTTTAATTA
CATGCGAGTTCTCTATTCG: ATGCGAGTTCTCTATTCGT
CATGCTTGCGCTGTGACCA: ATGCTTGCGCTGTGACCAG
CATGGAATTCGAGTCCCTG: ATGGAATTCGAGTCCCTGC
CATGGCGCATCGCGATAAA: ATGGCGCATCGCGATAAAC
CATGTCCCGACACATATTG: ATGTCCCGACACATATTGT
CATTAAGCGGACCATCTTT: ATTAAGCGGACCATCTTTC
CATTAATTTCGGGGTCGGG: ATTAATTTCGGGGTCGGGT
CATTATCAACTATTAACTC: ATTATCAACTATTAACTCG
CATTCACAAGCGTTCGGAC: ATTCACAAGCGTTCGGACG
CATTGAGTACCTGTTGCTT: ATTGAGTACCTGTTGCTTT
CATTGATGTGATCCTGGAA: ATTGATGTGATCCTGGAAA
CATTGCAGGTGAGACATTA: ATTGCAGGTGAGACATTAT
CATTGCCGACTTCAACAAT: ATTGCCGACTTCAACAATT
CATTTACAGATCTAGTTTT: ATTTACAGATCTAGTTTTA
CATTTTATCTCATATCCGA: ATTTTATCTCATATCCGAC
CCAACATCACGACATGAAT: CAACATCACGACATGAATG
CCAACATTTACAGATCTAG: CAACATTTACAGATCTAGT
CCAACGCCTGTTATTAACT: CAACGCCTGTTATTAACTC
CCAAGCATGGAATTCGAGT: CAAGCATGGAATTCGAGTC
CCAAGCTGCCATCCCGGCT: CAAGCTGCCATCCCGGCTG
CCAATAAATTAGACTGCGG: CAATAAATTAGACTGCGGG
CCAATATCTGACGGCGGGC: CAATATCTGACGGCGGGCA
CCAATTGACGCCCTTTGAT: CAATTGACGCCCTTTGATG
CCAATTTGAGCGACGTAAG: CAATTTGAGCGACGTAAGG
CCACACTGCACGGCACAGC: CACACTGCACGGCACAGCG
CCACAGAGTGAGGGCCGCG: CACAGAGTGAGGGCCGCGG
CCACCAACGCCTGTTATTA: CACCAACGCCTGTTATTAA
CCACCATAATCTTCCAACA: CACCATAATCTTCCAACAT
CCACCCGCATCCGTGTCAA: CACCCGCATCCGTGTCAAC
CCACCTTTATCCAATTGAC: CACCTTTATCCAATTGACG
CCACGGTAAGACTTGGAAA: CACGGTAAGACTTGGAAAT
CCACTCGTGAGTATAACAC: CACTCGTGAGTATAACACC
CCAGCATCCTTTCGTGTGA: CAGCATCCTTTCGTGTGAC
CCAGCATGTCCCGACACAT: CAGCATGTCCCGACACATA
CCAGCCAAGCATGGAATTC: CAGCCAAGCATGGAATTCG
CCAGCCGGTCAACTTGTCG: CAGCCGGTCAACTTGTCGA
CCAGCCTCAGTTACGGCAC: CAGCCTCAGTTACGGCACT
CCAGTTATAGCTCCCTTAT: CAGTTATAGCTCCCTTATG
CCATAATCTTCCAACATTT: CATAATCTTCCAACATTTA
CCATATCGTGCTTATAACT: CATATCGTGCTTATAACTA
CCATATGGCCAGCATCCTT: CATATGGCCAGCATCCTTT
CCATATTACGCGGTCGCGT: CATATTACGCGGTCGCGTA
CCATCCCGGCTGACAGCTG: CATCCCGGCTGACAGCTGC
CCATCTTTCCCGCACGTCC: CATCTTTCCCGCACGTCCA
CCATTAATTTCGGGGTCGG: CATTAATTTCGGGGTCGGG
CCATTGATGTGATCCTGGA: CATTGATGTGATCCTGGAA
CCATTGCCGACTTCAACAA: CATTGCCGACTTCAACAAT
CCCAATAAATTAGACTGCG: CCAATAAATTAGACTGCGG
CCCAATATCTGACGGCGGG: CCAATATCTGACGGCGGGC
CCCACACTGCACGGCACAG: CCACACTGCACGGCACAGC
CCCACCCGCATCCGTGTCA: CCACCCGCATCCGTGTCAA
CCCACCTTTATCCAATTGA: CCACCTTTATCCAATTGAC
CCCACTCGTGAGTATAACA: CCACTCGTGAGTATAACAC
CCCAGCATGTCCCGACACA: CCAGCATGTCCCGACACAT
CCCATTGATGTGATCCTGG: CCATTGATGTGATCCTGGA
CCCCACACTGCACGGCACA: CCCACACTGCACGGCACAG
CCCCACTCGTGAGTATAAC: CCCACTCGTGAGTATAACA
CCCGACACATATTGTCGCT: CCGACACATATTGTCGCTA
CCCGAGGGCTGTTGTGACC: CCGAGGGCTGTTGTGACCC
CCCGATCAGTGGTCGAGCA: CCGATCAGTGGTCGAGCAT
CCCGCACGTCCAACATCAC: CCGCACGTCCAACATCACG
CCCGCATCCGTGTCAACTG: CCGCATCCGTGTCAACTGC
CCCGGACGCCCATTGATGT: CCGGACGCCCATTGATGTG
CCCGGCTGACAGCTGCCTT: CCGGCTGACAGCTGCCTTT
CCCGGGCCATTAATTTCGG: CCGGGCCATTAATTTCGGG
CCCGGGGTATTAACTCGCA: CCGGGGTATTAACTCGCAG
CCCGTACAAGACAAAAGAG: CCGTACAAGACAAAAGAGG
CCCGTTATAATTAATAAGA: CCGTTATAATTAATAAGAA
CCCTAGGGGAAGTCCCAGC: CCTAGGGGAAGTCCCAGCA
CCCTCACACTTCAAAGGCC: CCTCACACTTCAAAGGCCT
CCCTCATTTTATCTCATAT: CCTCATTTTATCTCATATC
CCCTCGTCTTGGTAAGCGA: CCTCGTCTTGGTAAGCGAA
CCCTGCGGCTACTCACTTC: CCTGCGGCTACTCACTTCC
CCCTTATCGCATGCTTGCG: CCTTATCGCATGCTTGCGC
CCCTTATGGACGAGCCAGC: CCTTATGGACGAGCCAGCC
CCCTTCATACATCAACAAG: CCTTCATACATCAACAAGC
CCCTTTGATGCTCAAGGGG: CCTTTGATGCTCAAGGGGC
CCGAAACAGTTTGACCGAC: CGAAACAGTTTGACCGACT
CCGAACTTTAATTAGATGG: CGAACTTTAATTAGATGGT
CCGACACATATTGTCGCTA: CGACACATATTGTCGCTAG
CCGACCACAGAGTGAGGGC: CGACCACAGAGTGAGGGCC
CCGACTAATAGGGTTGTAA: CGACTAATAGGGTTGTAAC
CCGACTCGTCCATATGGCC: CGACTCGTCCATATGGCCA
CCGACTTCAACAATTCTCG: CGACTTCAACAATTCTCGC
CCGAGACGCTAGTATCGTA: CGAGACGCTAGTATCGTAG
CCGAGGGCTGTTGTGACCC: CGAGGGCTGTTGTGACCCT
CCGATCAGTGGTCGAGCAT: CGATCAGTGGTCGAGCATG
CCGCACCGTAGTCAGTGAC: CGCACCGTAGTCAGTGACA
CCGCACGTCCAACATCACG: CGCACGTCCAACATCACGA
CCGCATCCGTGTCAACTGC: CGCATCCGTGTCAACTGCG
CCGCCCTCACACTTCAAAG: CGCCCTCACACTTCAAAGG
CCGCGCTGTTATGCTCTAA: CGCGCTGTTATGCTCTAAT
CCGCGGCATACCCGAGGGC: CGCGGCATACCCGAGGGCT
CCGCGGCGGGTGCCGAGAC: CGCGGCGGGTGCCGAGACG
CCGCTCTCGCGATCGCGTA: CGCTCTCGCGATCGCGTAG
CCGCTGTATTCAATGATTC: CGCTGTATTCAATGATTCT
CCGGACGCCCATTGATGTG: CGGACGCCCATTGATGTGA
CCGGCTGACAGCTGCCTTT: CGGCTGACAGCTGCCTTTG
CCGGGCCATTAATTTCGGG: CGGGCCATTAATTTCGGGG
CCGGGGTATTAACTCGCAG: CGGGGTATTAACTCGCAGA
CCGGTCAACTTGTCGATAG: CGGTCAACTTGTCGATAGG
CCGTACAAGACAAAAGAGG: CGTACAAGACAAAAGAGGG
CCGTAGGTGGATCTCCTCT: CGTAGGTGGATCTCCTCTT
CCGTAGTCAGTGACATATT: CGTAGTCAGTGACATATTA
CCGTGGGATCCGTGTCTAT: CGTGGGATCCGTGTCTATA
CCGTGTCAACTGCGCCGCT: CGTGTCAACTGCGCCGCTG
CCGTGTCTATATTCGGGAG: CGTGTCTATATTCGGGAGC
CCGTTATAATTAATAAGAA: CGTTATAATTAATAAGAAT
CCTAACGGGCGGGCTTAAG: CTAACGGGCGGGCTTAAGC
CCTAATTGCTGTCATGCGA: CTAATTGCTGTCATGCGAG
CCTACAGAACAGAACGCAA: CTACAGAACAGAACGCAAT
CCTACCCCACTCGTGAGTA: CTACCCCACTCGTGAGTAT
CCTACTACTTGCACGTCAT: CTACTACTTGCACGTCATC
CCTAGATCAGTGGTCGAGC: CTAGATCAGTGGTCGAGCA
CCTAGGGGAAGTCCCAGCA: CTAGGGGAAGTCCCAGCAT
CCTCACACTTCAAAGGCCT: CTCACACTTCAAAGGCCTG
CCTCAGTTACGGCACTATT: CTCAGTTACGGCACTATTT
CCTCATTTTATCTCATATC: CTCATTTTATCTCATATCC
CCTCGTCTTGGTAAGCGAA: CTCGTCTTGGTAAGCGAAC
CCTCTCGGGAGCTCCTAAT: CTCTCGGGAGCTCCTAATT
CCTCTTCACGCACATCACG: CTCTTCACGCACATCACGC
CCTCTTGGTGCGTGAAGTA: CTCTTGGTGCGTGAAGTAG
CCTGCCACCAACGCCTGTT: CTGCCACCAACGCCTGTTA
CCTGCGCCAAGCTGCCATC: CTGCGCCAAGCTGCCATCC
CCTGCGGCTACTCACTTCC: CTGCGGCTACTCACTTCCT
CCTGCTCAATGGCCGCGCT: CTGCTCAATGGCCGCGCTG
CCTGGAAACTTGGAGGCAA: CTGGAAACTTGGAGGCAAT
CCTGTATGACCCGATCAGT: CTGTATGACCCGATCAGTG
CCTGTATGTAAGTCGGGTA: CTGTATGTAAGTCGGGTAT
CCTGTGCAAAGCTAGCTAG: CTGTGCAAAGCTAGCTAGG
CCTGTTATTAACTCGCAGA: CTGTTATTAACTCGCAGAT
CCTGTTGCTTTCAGGCTGA: CTGTTGCTTTCAGGCTGAA
CCTTATCGCATGCTTGCGC: CTTATCGCATGCTTGCGCT
CCTTATGGACGAGCCAGCC: CTTATGGACGAGCCAGCCA
CCTTCATACATCAACAAGC: CTTCATACATCAACAAGCT
CCTTTATCCAATTGACGCC: CTTTATCCAATTGACGCCC
CCTTTCGTGTGACCATATT: CTTTCGTGTGACCATATTA
CCTTTGATGCTCAAGGGGC: CTTTGATGCTCAAGGGGCT
CCTTTGCCATTGCCGACTT: CTTTGCCATTGCCGACTTC
CCTTTGGGATACTTCCAGC: CTTTGGGATACTTCCAGCC
CGAAACAGTTTGACCGACT: GAAACAGTTTGACCGACTC
CGAAAGCATAAATATTAAC: GAAAGCATAAATATTAACT
CGAACCCTAGGGGAAGTCC: GAACCCTAGGGGAAGTCCC
CGAACTTTAATTAGATGGT: GAACTTTAATTAGATGGTA
CGAAGCCGCCCTCACACTT: GAAGCCGCCCTCACACTTC
CGAAGTAGAGCGGGTGATT: GAAGTAGAGCGGGTGATTC
CGAATCTGAATGGGATTAT: GAATCTGAATGGGATTATC
CGAATGCCTTTGCCATTGC: GAATGCCTTTGCCATTGCC
CGACACATATTGTCGCTAG: GACACATATTGTCGCTAGC
CGACATGAATGCTCTTGAG: GACATGAATGCTCTTGAGA
CGACCACAGAGTGAGGGCC: GACCACAGAGTGAGGGCCG
CGACGTAAGGGTAGAGTAT: GACGTAAGGGTAGAGTATA
CGACTAATAGGGTTGTAAC: GACTAATAGGGTTGTAACG
CGACTCGTCCATATGGCCA: GACTCGTCCATATGGCCAG
CGACTTCAACAATTCTCGC: GACTTCAACAATTCTCGCC
CGAGACGCTAGTATCGTAG: GAGACGCTAGTATCGTAGT
CGAGCATGAAAGGCCAGCC: GAGCATGAAAGGCCAGCCG
CGAGCATGACGGTTGTTGG: GAGCATGACGGTTGTTGGG
CGAGCATGAGATGACTCAT: GAGCATGAGATGACTCATT
CGAGCATGAGCCGAACTTT: GAGCATGAGCCGAACTTTA
CGAGCCAGCCAAGCATGGA: GAGCCAGCCAAGCATGGAA
CGAGGGCTGTTGTGACCCT: GAGGGCTGTTGTGACCCTT
CGAGTCCCTGCGGCTACTC: GAGTCCCTGCGGCTACTCA
CGAGTTCTCTATTCGTGCG: GAGTTCTCTATTCGTGCGT
CGAGTTTCTTTAACGGCCG: GAGTTTCTTTAACGGCCGA
CGATAAACATCGGGGCGGG: GATAAACATCGGGGCGGGA
CGATAGCGAAGCCGCCCTC: GATAGCGAAGCCGCCCTCA
CGATAGGCGGACGCGTCGG: GATAGGCGGACGCGTCGGC
CGATATGGTAGGTGTGACT: GATATGGTAGGTGTGACTG
CGATCAGTGGTCGAGCATG: GATCAGTGGTCGAGCATGA GATCAGTGGTCGAGCATGA
CGATCGCGTAGGATCTGAC: GATCGCGTAGGATCTGACA
CGCAATAACTGGAGTTTAG: GCAATAACTGGAGTTTAGA
CGCACAATACACCGTGGGA: GCACAATACACCGTGGGAT
CGCACATCACGCATACATC: GCACATCACGCATACATCT
CGCACCGTAGTCAGTGACA: GCACCGTAGTCAGTGACAT
CGCACGTCCAACATCACGA: GCACGTCCAACATCACGAC
CGCAGATCTCATATCGGTT: GCAGATCTCATATCGGTTG
CGCAGATCTCCTGTATGAC: GCAGATCTCCTGTATGACC
CGCAGATCTCGGCAGAACA: GCAGATCTCGGCAGAACAT
CGCAGATCTCTACGGTTCC: GCAGATCTCTACGGTTCCT
CGCATACATCTATCCTGTG: GCATACATCTATCCTGTGC
CGCATCCGTGTCAACTGCG: GCATCCGTGTCAACTGCGC
CGCATCGCGATAAACATCG: GCATCGCGATAAACATCGG
CGCATGCTTGCGCTGTGAC: GCATGCTTGCGCTGTGACC
CGCATTGAGTACCTGTTGC: GCATTGAGTACCTGTTGCT
CGCCAAGCTGCCATCCCGG: GCCAAGCTGCCATCCCGGC
CGCCAATTTGAGCGACGTA: GCCAATTTGAGCGACGTAA
CGCCCATTGATGTGATCCT: GCCCATTGATGTGATCCTG
CGCCCGGGCCATTAATTTC: GCCCGGGCCATTAATTTCG
CGCCCGTTATAATTAATAA: GCCCGTTATAATTAATAAG
CGCCCTCACACTTCAAAGG: GCCCTCACACTTCAAAGGC
CGCCCTTTGATGCTCAAGG: GCCCTTTGATGCTCAAGGG
CGCCGCTGTATTCAATGAT: GCCGCTGTATTCAATGATT
CGCCTACCCCACTCGTGAG: GCCTACCCCACTCGTGAGT
CGCCTGCCACCAACGCCTG: GCCTGCCACCAACGCCTGT
CGCCTGTTATTAACTCGCA: GCCTGTTATTAACTCGCAG
CGCGATAAACATCGGGGCG: GCGATAAACATCGGGGCGG
CGCGATCGCGTAGGATCTG: GCGATCGCGTAGGATCTGA
CGCGCCCGTTATAATTAAT: GCGCCCGTTATAATTAATA
CGCGCTGTTATGCTCTAAT: GCGCTGTTATGCTCTAATA
CGCGGCATACCCGAGGGCT: GCGGCATACCCGAGGGCTG
CGCGGCGGGTGCCGAGACG: GCGGCGGGTGCCGAGACGC
CGCGGTCGCGTATATAGGC: GCGGTCGCGTATATAGGCC
CGCGTAAATATACGCACAA: GCGTAAATATACGCACAAT
CGCGTAGGATCTGACAGCT: GCGTAGGATCTGACAGCTG
CGCGTATATAGGCCCAATA: GCGTATATAGGCCCAATAA
CGCGTCGGCCATATCGTGC: GCGTCGGCCATATCGTGCT
CGCTAGCGTCACCCGGACG: GCTAGCGTCACCCGGACGC
CGCTAGGATAGTGACGCTT: GCTAGGATAGTGACGCTTT
CGCTAGTATCGTAGTCCAC: GCTAGTATCGTAGTCCACC
CGCTATATCATATCGGAAC: GCTATATCATATCGGAACG
CGCTCTCGCGATCGCGTAG: GCTCTCGCGATCGCGTAGG
CGCTGATGTCGTTCGAAAG: GCTGATGTCGTTCGAAAGC
CGCTGTATTCAATGATTCT: GCTGTATTCAATGATTCTC
CGCTGTGACCAGTTATAGC: GCTGTGACCAGTTATAGCT
CGCTGTTATGCTCTAATAA: GCTGTTATGCTCTAATAAT
CGCTTTAGCAGTGTAAAGA: GCTTTAGCAGTGTAAAGAG
CGGAACGAAGTAGAGCGGG: GGAACGAAGTAGAGCGGGT
CGGACCATCTTTCCCGCAC: GGACCATCTTTCCCGCACG
CGGACGCATTGAGTACCTG: GGACGCATTGAGTACCTGT
CGGACGCCCATTGATGTGA: GGACGCCCATTGATGTGAT
CGGACGCGTCGGCCATATC: GGACGCGTCGGCCATATCG
CGGCACAGCGCCCGGGCCA: GGCACAGCGCCCGGGCCAT
CGGCACTATTTGCACACGG: GGCACTATTTGCACACGGC
CGGCAGAACATAGATCAGT: GGCAGAACATAGATCAGTG
CGGCATACCCGAGGGCTGT: GGCATACCCGAGGGCTGTT
CGGCCATATCGTGCTTATA: GGCCATATCGTGCTTATAA
CGGCCGAAACAGTTTGACC: GGCCGAAACAGTTTGACCG
CGGCGGGCACTTATGCCGA: GGCGGGCACTTATGCCGAC
CGGCGGGTGCCGAGACGCT: GGCGGGTGCCGAGACGCTA
CGGCGTTTATCATAATTAG: GGCGTTTATCATAATTAGC
CGGCTAATCGCGCCCGTTA: GGCTAATCGCGCCCGTTAT
CGGCTACTCACTTCCTGTA: GGCTACTCACTTCCTGTAT
CGGCTGACAGCTGCCTTTG: GGCTGACAGCTGCCTTTGG
CGGCTTGGGCCACGGTAAG: GGCTTGGGCCACGGTAAGA
CGGGAAATACATGGCGCAT: GGGAAATACATGGCGCATC
CGGGAACCTGCTCAATGGC: GGGAACCTGCTCAATGGCC
CGGGAGCCTAACGGGCGGG: GGGAGCCTAACGGGCGGGC
CGGGAGCTCCTAATTGCTG: GGGAGCTCCTAATTGCTGT
CGGGCACTTATGCCGACTA: GGGCACTTATGCCGACTAA
CGGGCCATTAATTTCGGGG: GGGCCATTAATTTCGGGGT
CGGGCGGGCTTAAGCTGTA: GGGCGGGCTTAAGCTGTAA
CGGGCGGGTCATCTGACAA: GGGCGGGTCATCTGACAAT
CGGGCTTAAGCTGTAACAG: GGGCTTAAGCTGTAACAGG
CGGGGCGGGAACCTGCTCA: GGGGCGGGAACCTGCTCAA
CGGGGTATTAACTCGCAGA: GGGGTATTAACTCGCAGAT
CGGGGTCGGGTCCCGGGGT: GGGGTCGGGTCCCGGGGTA
CGGGTATCATTGCAGGTGA: GGGTATCATTGCAGGTGAG
CGGGTCATCTGACAATTCT: GGGTCATCTGACAATTCTA
CGGGTCCCGGGGTATTAAC: GGGTCCCGGGGTATTAACT
CGGGTGATTCTGGTCTTTA: GGGTGATTCTGGTCTTTAT
CGGGTGCCGAGACGCTAGT: GGGTGCCGAGACGCTAGTA
CGGTAAGACTTGGAAATCC: GGTAAGACTTGGAAATCCT
CGGTCAAAACTTATACACG: GGTCAAAACTTATACACGC
CGGTCAACTTGTCGATAGG: GGTCAACTTGTCGATAGGC
CGGTCCGTAGGTGGATCTC: GGTCCGTAGGTGGATCTCC
CGGTCGCGTATATAGGCCC: GGTCGCGTATATAGGCCCA
CGGTCTAAGCGCCTGCCAC: GGTCTAAGCGCCTGCCACC
CGGTTATGCCCACCCGCAT: GGTTATGCCCACCCGCATC
CGGTTCCTAGATCAGTGGT: GGTTCCTAGATCAGTGGTC
CGGTTGCGATCAGTGGTCG: GGTTGCGATCAGTGGTCGA
CGGTTGTTGGGGCTGACCC: GGTTGTTGGGGCTGACCCT
CGTAAATATACGCACAATA: GTAAATATACGCACAATAC
CGTAACGATAGCGAAGCCG: GTAACGATAGCGAAGCCGC
CGTAAGGGTAGAGTATACC: GTAAGGGTAGAGTATACCT
CGTACAAGACAAAAGAGGG: GTACAAGACAAAAGAGGGG
CGTAGGATCTGACAGCTGA: GTAGGATCTGACAGCTGAC
CGTAGGTGGATCTCCTCTT: GTAGGTGGATCTCCTCTTG
CGTAGTCAGTGACATATTA: GTAGTCAGTGACATATTAT
CGTAGTCCACCATAATCTT: GTAGTCCACCATAATCTTC
CGTATATAGGCCCAATAAA: GTATATAGGCCCAATAAAT
CGTCACCCGGACGCCCATT: GTCACCCGGACGCCCATTG
CGTCATCTTCCCACCTTTA: GTCATCTTCCCACCTTTAT
CGTCCAACATCACGACATG: GTCCAACATCACGACATGA
CGTCCATATGGCCAGCATC: GTCCATATGGCCAGCATCC
CGTCGGCCATATCGTGCTT: GTCGGCCATATCGTGCTTA
CGTCTTGGTAAGCGAACCC: GTCTTGGTAAGCGAACCCT
CGTGAAGTAGAACCCTCAT: GTGAAGTAGAACCCTCATT
CGTGAGTATAACACCCAAT: GTGAGTATAACACCCAATA
CGTGCGAGTTTCTTTAACG: GTGCGAGTTTCTTTAACGG
CGTGCGTGGTCGGTCCGTA: GTGCGTGGTCGGTCCGTAG
CGTGCTTATAACTATTTAC: GTGCTTATAACTATTTACG
CGTGGGATCCGTGTCTATA: GTGGGATCCGTGTCTATAT
CGTGGTCGGTCCGTAGGTG: GTGGTCGGTCCGTAGGTGG
CGTGTACATTCACAAGCGT: GTGTACATTCACAAGCGTT
CGTGTCAACTGCGCCGCTG: GTGTCAACTGCGCCGCTGT
CGTGTCTATATTCGGGAGC: GTGTCTATATTCGGGAGCC
CGTGTGACCATATTACGCG: GTGTGACCATATTACGCGG
CGTTATAATTAATAAGAAT: GTTATAATTAATAAGAATC
CGTTCGAAAGCATAAATAT: GTTCGAAAGCATAAATATT
CGTTCGGACGCATTGAGTA: GTTCGGACGCATTGAGTAC
CGTTTATCATAATTAGCCT: GTTTATCATAATTAGCCTA
CTAACGGGCGGGCTTAAGC: TAACGGGCGGGCTTAAGCT
CTAAGCGCCTGCCACCAAC: TAAGCGCCTGCCACCAACG
CTAATAATACAGTGTACAC: TAATAATACAGTGTACACA
CTAATAGGGTTGTAACGTA: TAATAGGGTTGTAACGTAA
CTAATCGCGCCCGTTATAA: TAATCGCGCCCGTTATAAT
CTAATTGCTGTCATGCGAG: TAATTGCTGTCATGCGAGT
CTACAGAACAGAACGCAAT: TACAGAACAGAACGCAATA
CTACCCCACTCGTGAGTAT: TACCCCACTCGTGAGTATA
CTACGGTTCCTAGATCAGT: TACGGTTCCTAGATCAGTG
CTACTACTTGCACGTCATC: TACTACTTGCACGTCATCT
CTACTCACTTCCTGTATGT: TACTCACTTCCTGTATGTA
CTACTTGCACGTCATCTTC: TACTTGCACGTCATCTTCC
CTAGACGCGTAAATATACG: TAGACGCGTAAATATACGC
CTAGATACTGTGAGCGCTG: TAGATACTGTGAGCGCTGA
CTAGATCAGTGGTCGAGCA: TAGATCAGTGGTCGAGCAT
CTAGCGTCACCCGGACGCC: TAGCGTCACCCGGACGCCC
CTAGCTAGGGGATCCTCTC: TAGCTAGGGGATCCTCTCG
CTAGGATAGTGACGCTTTA: TAGGATAGTGACGCTTTAG
CTAGGCATCCGCACCGTAG: TAGGCATCCGCACCGTAGT
CTAGGGGAAGTCCCAGCAT: TAGGGGAAGTCCCAGCATG
CTAGGGGATCCTCTCGGGA: TAGGGGATCCTCTCGGGAG
CTAGTATCGTAGTCCACCA: TAGTATCGTAGTCCACCAT
CTAGTTTTACTCTGTAAAC: TAGTTTTACTCTGTAAACG
CTATATCATATCGGAACGA: TATATCATATCGGAACGAA
CTATATTCGGGAGCCTAAC: TATATTCGGGAGCCTAACG
CTATCCTGTGCAAAGCTAG: TATCCTGTGCAAAGCTAGC
CTATCGTGTACATTCACAA: TATCGTGTACATTCACAAG
CTATTAACTCGCAGATCTC: TATTAACTCGCAGATCTCC
CTATTCGTGCGTGGTCGGT: TATTCGTGCGTGGTCGGTC
CTATTTACGGTTATGCCCA: TATTTACGGTTATGCCCAC
CTATTTGCACACGGCTTGG: TATTTGCACACGGCTTGGG
CTCAAGGGGCTTGACGTGC: TCAAGGGGCTTGACGTGCG
CTCAATGGCCGCGCTGTTA: TCAATGGCCGCGCTGTTAT
CTCACACTTCAAAGGCCTG: TCACACTTCAAAGGCCTGC
CTCACTTCCTGTATGTAAG: TCACTTCCTGTATGTAAGT
CTCAGTTACGGCACTATTT: TCAGTTACGGCACTATTTG
CTCATATCCGACCACAGAG: TCATATCCGACCACAGAGT
CTCATATCGGTTGCGATCA: TCATATCGGTTGCGATCAG
CTCATTAAGCGGACCATCT: TCATTAAGCGGACCATCTT
CTCATTTTATCTCATATCC: TCATTTTATCTCATATCCG
CTCCCTTATGGACGAGCCA: TCCCTTATGGACGAGCCAG
CTCCTAATTGCTGTCATGC: TCCTAATTGCTGTCATGCG
CTCCTCTTGGTGCGTGAAG: TCCTCTTGGTGCGTGAAGT
CTCCTGTATGACCCGATCA: TCCTGTATGACCCGATCAG
CTCGCAGATCTCATATCGG: TCGCAGATCTCATATCGGT
CTCGCAGATCTCCTGTATG: TCGCAGATCTCCTGTATGA
CTCGCAGATCTCGGCAGAA: TCGCAGATCTCGGCAGAAC
CTCGCAGATCTCTACGGTT: TCGCAGATCTCTACGGTTC
CTCGCCTACCCCACTCGTG: TCGCCTACCCCACTCGTGA
CTCGCGATCGCGTAGGATC: TCGCGATCGCGTAGGATCT
CTCGGCAGAACATAGATCA: TCGGCAGAACATAGATCAG
CTCGGCTAATCGCGCCCGT: TCGGCTAATCGCGCCCGTT
CTCGGGAGCTCCTAATTGC: TCGGGAGCTCCTAATTGCT
CTCGGTCAAAACTTATACA: TCGGTCAAAACTTATACAC
CTCGTCCATATGGCCAGCA: TCGTCCATATGGCCAGCAT
CTCGTCTTGGTAAGCGAAC: TCGTCTTGGTAAGCGAACC
CTCGTGAGTATAACACCCA: TCGTGAGTATAACACCCAA
CTCTAATAATACAGTGTAC: TCTAATAATACAGTGTACA
CTCTACGGTTCCTAGATCA: TCTACGGTTCCTAGATCAG
CTCTATTCGTGCGTGGTCG: TCTATTCGTGCGTGGTCGG
CTCTCGCGATCGCGTAGGA: TCTCGCGATCGCGTAGGAT
CTCTCGGGAGCTCCTAATT: TCTCGGGAGCTCCTAATTG
CTCTGTAAACGGTCTAAGC: TCTGTAAACGGTCTAAGCG
CTCTTCACGCACATCACGC: TCTTCACGCACATCACGCA
CTCTTGAGAACTGCCCCAC: TCTTGAGAACTGCCCCACA
CTCTTGGTGCGTGAAGTAG: TCTTGGTGCGTGAAGTAGA
CTGAACTGGCGGGAAATAC: TGAACTGGCGGGAAATACA
CTGAATGGGATTATCGATA: TGAATGGGATTATCGATAT
CTGACAATTCTAGGCATCC: TGACAATTCTAGGCATCCG
CTGACAGCTGACCGCGGCA: TGACAGCTGACCGCGGCAT
CTGACAGCTGCCTTTGGGA: TGACAGCTGCCTTTGGGAT
CTGACCCTCGTCTTGGTAA: TGACCCTCGTCTTGGTAAG
CTGACCGCGGCATACCCGA: TGACCGCGGCATACCCGAG
CTGACGGCGGGCACTTATG: TGACGGCGGGCACTTATGC
CTGATGTCGTTCGAAAGCA: TGATGTCGTTCGAAAGCAT
CTGCACGGCACAGCGCCCG: TGCACGGCACAGCGCCCGG
CTGCCACCAACGCCTGTTA: TGCCACCAACGCCTGTTAT
CTGCCATCCCGGCTGACAG: TGCCATCCCGGCTGACAGC
CTGCCCCACACTGCACGGC: TGCCCCACACTGCACGGCA
CTGCCTTTGGGATACTTCC: TGCCTTTGGGATACTTCCA
CTGCGCCAAGCTGCCATCC: TGCGCCAAGCTGCCATCCC
CTGCGCCGCTGTATTCAAT: TGCGCCGCTGTATTCAATG
CTGCGGCTACTCACTTCCT: TGCGGCTACTCACTTCCTG
CTGCGGGCGGGTCATCTGA: TGCGGGCGGGTCATCTGAC
CTGCTCAATGGCCGCGCTG: TGCTCAATGGCCGCGCTGT
CTGGAAACTTGGAGGCAAT: TGGAAACTTGGAGGCAATG
CTGGAGTTTAGAGGAAGAA: TGGAGTTTAGAGGAAGAAA
CTGGCGGGAAATACATGGC: TGGCGGGAAATACATGGCG
CTGGTCTTTATAAGTTTGA: TGGTCTTTATAAGTTTGAG
CTGTAAACGGTCTAAGCGC: TGTAAACGGTCTAAGCGCC
CTGTAACAGGCTAGATACT: TGTAACAGGCTAGATACTG
CTGTAATCGGCGTTTATCA: TGTAATCGGCGTTTATCAT
CTGTATGACCCGATCAGTG: TGTATGACCCGATCAGTGG
CTGTATGTAAGTCGGGTAT: TGTATGTAAGTCGGGTATC
CTGTATTCAATGATTCTCG: TGTATTCAATGATTCTCGG
CTGTCATGCGAGTTCTCTA: TGTCATGCGAGTTCTCTAT
CTGTGACCAGTTATAGCTC: TGTGACCAGTTATAGCTCC
CTGTGAGCGCTGATGTCGT: TGTGAGCGCTGATGTCGTT
CTGTGCAAAGCTAGCTAGG: TGTGCAAAGCTAGCTAGGG
CTGTTATGCTCTAATAATA: TGTTATGCTCTAATAATAC
CTGTTATTAACTCGCAGAT: TGTTATTAACTCGCAGATC
CTGTTGCTTTCAGGCTGAA: TGTTGCTTTCAGGCTGAAC
CTGTTGTGACCCTTATCGC: TGTTGTGACCCTTATCGCA
CTTAAGCTGTAACAGGCTA: TTAAGCTGTAACAGGCTAG
CTTATAACTATTTACGGTT: TTATAACTATTTACGGTTA
CTTATACACGCCAATTTGA: TTATACACGCCAATTTGAG
CTTATCGCATGCTTGCGCT: TTATCGCATGCTTGCGCTG
CTTATGCCGACTAATAGGG: TTATGCCGACTAATAGGGT
CTTATGGACGAGCCAGCCA: TTATGGACGAGCCAGCCAA
CTTCAAAGGCCTGCGCCAA: TTCAAAGGCCTGCGCCAAG
CTTCAACAATTCTCGCCTA: TTCAACAATTCTCGCCTAC
CTTCACGCACATCACGCAT: TTCACGCACATCACGCATA
CTTCATACATCAACAAGCT: TTCATACATCAACAAGCTA
CTTCCAACATTTACAGATC: TTCCAACATTTACAGATCT
CTTCCAGCCTCAGTTACGG: TTCCAGCCTCAGTTACGGC
CTTCCCACCTTTATCCAAT: TTCCCACCTTTATCCAATT
CTTCCTGTATGTAAGTCGG: TTCCTGTATGTAAGTCGGG
CTTGACGTGCGAGTTTCTT: TTGACGTGCGAGTTTCTTT
CTTGAGAACTGCCCCACAC: TTGAGAACTGCCCCACACT
CTTGCACGTCATCTTCCCA: TTGCACGTCATCTTCCCAC
CTTGCGCTGTGACCAGTTA: TTGCGCTGTGACCAGTTAT
CTTGGAAATCCTCTTCACG: TTGGAAATCCTCTTCACGC
CTTGGAGGCAATGATGTGA: TTGGAGGCAATGATGTGAC
CTTGGGCCACGGTAAGACT: TTGGGCCACGGTAAGACTT
CTTGGTAAGCGAACCCTAG: TTGGTAAGCGAACCCTAGG
CTTGGTGCGTGAAGTAGAA: TTGGTGCGTGAAGTAGAAC
CTTGTCGATAGGCGGACGC: TTGTCGATAGGCGGACGCG
CTTTAACGGCCGAAACAGT: TTTAACGGCCGAAACAGTT
CTTTAATTAGATGGTATTC: TTTAATTAGATGGTATTCC
CTTTAGCAGTGTAAAGAGT: TTTAGCAGTGTAAAGAGTG
CTTTATAAGTTTGAGTGAA: TTTATAAGTTTGAGTGAAG
CTTTATCCAATTGACGCCC: TTTATCCAATTGACGCCCT
CTTTCAGGCTGAACTGGCG: TTTCAGGCTGAACTGGCGG
CTTTCCCGCACGTCCAACA: TTTCCCGCACGTCCAACAT
CTTTCGTGTGACCATATTA: TTTCGTGTGACCATATTAC
CTTTGATGCTCAAGGGGCT: TTTGATGCTCAAGGGGCTT
CTTTGCCATTGCCGACTTC: TTTGCCATTGCCGACTTCA
CTTTGGGATACTTCCAGCC: TTTGGGATACTTCCAGCCT
GAAACAGTTTGACCGACTC: AAACAGTTTGACCGACTCG
GAAACTTGGAGGCAATGAT: AAACTTGGAGGCAATGATG
GAAAGCATAAATATTAACT: AAAGCATAAATATTAACTC
GAAAGGCCAGCCGGTCAAC: AAAGGCCAGCCGGTCAACT
GAAAGGCTCGGCTAATCGC: AAAGGCTCGGCTAATCGCG
GAAATACATGGCGCATCGC: AAATACATGGCGCATCGCG
GAAATCCTCTTCACGCACA: AAATCCTCTTCACGCACAT
GAACAGAACGCAATAACTG: AACAGAACGCAATAACTGG
GAACATAGATCAGTGGTCG: AACATAGATCAGTGGTCGA
GAACCCTAGGGGAAGTCCC: AACCCTAGGGGAAGTCCCA
GAACCCTCATTTTATCTCA: AACCCTCATTTTATCTCAT
GAACCTGCTCAATGGCCGC: AACCTGCTCAATGGCCGCG
GAACGAAGTAGAGCGGGTG: AACGAAGTAGAGCGGGTGA
GAACGCAATAACTGGAGTT: AACGCAATAACTGGAGTTT
GAACTGCCCCACACTGCAC: AACTGCCCCACACTGCACG
GAACTGGCGGGAAATACAT: AACTGGCGGGAAATACATG
GAACTTTAATTAGATGGTA: AACTTTAATTAGATGGTAT
GAAGAAAGGCTCGGCTAAT: AAGAAAGGCTCGGCTAATC
GAAGCCGCCCTCACACTTC: AAGCCGCCCTCACACTTCA
GAAGGCCGCTCTCGCGATC: AAGGCCGCTCTCGCGATCG
GAAGTAGAACCCTCATTTT: AAGTAGAACCCTCATTTTA
GAAGTAGAGCGGGTGATTC: AAGTAGAGCGGGTGATTCT
GAAGTCCCAGCATGTCCCG: AAGTCCCAGCATGTCCCGA
GAATCTATCGTGTACATTC: AATCTATCGTGTACATTCA
GAATCTGAATGGGATTATC: AATCTGAATGGGATTATCG
GAATGCCTTTGCCATTGCC: AATGCCTTTGCCATTGCCG
GAATGCTCTTGAGAACTGC: AATGCTCTTGAGAACTGCC
GAATGGGATTATCGATATG: AATGGGATTATCGATATGG
GAATTCGAGTCCCTGCGGC: AATTCGAGTCCCTGCGGCT
GACAAAAGAGGGGGACCCT: ACAAAAGAGGGGGACCCTT
GACAATTCTAGGCATCCGC: ACAATTCTAGGCATCCGCA
GACACATATTGTCGCTAGC: ACACATATTGTCGCTAGCG
GACAGCTGACCGCGGCATA: ACAGCTGACCGCGGCATAC
GACAGCTGCCTTTGGGATA: ACAGCTGCCTTTGGGATAC
GACATATTATCGCTAGGAT: ACATATTATCGCTAGGATA
GACATGAATGCTCTTGAGA: ACATGAATGCTCTTGAGAA
GACATTATCAACTATTAAC: ACATTATCAACTATTAACT
GACCACAGAGTGAGGGCCG: ACCACAGAGTGAGGGCCGC
GACCAGTTATAGCTCCCTT: ACCAGTTATAGCTCCCTTA
GACCATATTACGCGGTCGC: ACCATATTACGCGGTCGCG
GACCATCTTTCCCGCACGT: ACCATCTTTCCCGCACGTC
GACCCGATCAGTGGTCGAG: ACCCGATCAGTGGTCGAGC
GACCCTCGTCTTGGTAAGC: ACCCTCGTCTTGGTAAGCG
GACCCTTATCGCATGCTTG: ACCCTTATCGCATGCTTGC
GACCCTTCATACATCAACA: ACCCTTCATACATCAACAA
GACCGACTCGTCCATATGG: ACCGACTCGTCCATATGGC
GACCGCGGCATACCCGAGG: ACCGCGGCATACCCGAGGG
GACGAATGCCTTTGCCATT: ACGAATGCCTTTGCCATTG
GACGAGCCAGCCAAGCATG: ACGAGCCAGCCAAGCATGG
GACGCATTGAGTACCTGTT: ACGCATTGAGTACCTGTTG
GACGCCCATTGATGTGATC: ACGCCCATTGATGTGATCC
GACGCCCTTTGATGCTCAA: ACGCCCTTTGATGCTCAAG
GACGCGTAAATATACGCAC: ACGCGTAAATATACGCACA
GACGCGTCGGCCATATCGT: ACGCGTCGGCCATATCGTG
GACGCTAGTATCGTAGTCC: ACGCTAGTATCGTAGTCCA
GACGCTTTAGCAGTGTAAA: ACGCTTTAGCAGTGTAAAG
GACGGCGGGCACTTATGCC: ACGGCGGGCACTTATGCCG
GACGGTTGTTGGGGCTGAC: ACGGTTGTTGGGGCTGACC
GACGTAAGGGTAGAGTATA: ACGTAAGGGTAGAGTATAC
GACGTGCGAGTTTCTTTAA: ACGTGCGAGTTTCTTTAAC
GACTAATAGGGTTGTAACG: ACTAATAGGGTTGTAACGT
GACTCATTAAGCGGACCAT: ACTCATTAAGCGGACCATC
GACTCGTCCATATGGCCAG: ACTCGTCCATATGGCCAGC
GACTGCGGGCGGGTCATCT: ACTGCGGGCGGGTCATCTG
GACTGTAATCGGCGTTTAT: ACTGTAATCGGCGTTTATC
GACTTCAACAATTCTCGCC: ACTTCAACAATTCTCGCCT
GACTTGGAAATCCTCTTCA: ACTTGGAAATCCTCTTCAC
GAGAACTGCCCCACACTGC: AGAACTGCCCCACACTGCA
GAGACATTATCAACTATTA: AGACATTATCAACTATTAA
GAGACGCTAGTATCGTAGT: AGACGCTAGTATCGTAGTC
GAGATGACTCATTAAGCGG: AGATGACTCATTAAGCGGA
GAGCATGAAAGGCCAGCCG: AGCATGAAAGGCCAGCCGG
GAGCATGACGGTTGTTGGG: AGCATGACGGTTGTTGGGG
GAGCATGAGATGACTCATT: AGCATGAGATGACTCATTA
GAGCATGAGCCGAACTTTA: AGCATGAGCCGAACTTTAA
GAGCCAGCCAAGCATGGAA: AGCCAGCCAAGCATGGAAT
GAGCCGAACTTTAATTAGA: AGCCGAACTTTAATTAGAT
GAGCCTAACGGGCGGGCTT: AGCCTAACGGGCGGGCTTA
GAGCGACGTAAGGGTAGAG: AGCGACGTAAGGGTAGAGT
GAGCGCTGATGTCGTTCGA: AGCGCTGATGTCGTTCGAA
GAGCGGGTGATTCTGGTCT: AGCGGGTGATTCTGGTCTT
GAGCTCCTAATTGCTGTCA: AGCTCCTAATTGCTGTCAT
GAGGAAGAAAGGCTCGGCT: AGGAAGAAAGGCTCGGCTA
GAGGCAATGATGTGACGAA: AGGCAATGATGTGACGAAT
GAGGGCCGCGGCGGGTGCC: AGGGCCGCGGCGGGTGCCG
GAGGGCTGTTGTGACCCTT: AGGGCTGTTGTGACCCTTA
GAGGGGGACCCTTCATACA: AGGGGGACCCTTCATACAT
GAGTACCTGTTGCTTTCAG: AGTACCTGTTGCTTTCAGG
GAGTATAACACCCAATATC: AGTATAACACCCAATATCT
GAGTATACCTACAGAACAG: AGTATACCTACAGAACAGA
GAGTCCCTGCGGCTACTCA: AGTCCCTGCGGCTACTCAC
GAGTGAAGGCCGCTCTCGC: AGTGAAGGCCGCTCTCGCG
GAGTGAGGGCCGCGGCGGG: AGTGAGGGCCGCGGCGGGT
GAGTGGATAAAAGCAAACC: AGTGGATAAAAGCAAACCC
GAGTTCTCTATTCGTGCGT: AGTTCTCTATTCGTGCGTG
GAGTTTAGAGGAAGAAAGG: AGTTTAGAGGAAGAAAGGC
GAGTTTCTTTAACGGCCGA: AGTTTCTTTAACGGCCGAA
GATAAAAGCAAACCCGTAC: ATAAAAGCAAACCCGTACA
GATAAACATCGGGGCGGGA: ATAAACATCGGGGCGGGAA
GATACTGTGAGCGCTGATG: ATACTGTGAGCGCTGATGT
GATACTTCCAGCCTCAGTT: ATACTTCCAGCCTCAGTTA
GATAGCGAAGCCGCCCTCA: ATAGCGAAGCCGCCCTCAC
GATAGGCGGACGCGTCGGC: ATAGGCGGACGCGTCGGCC
GATAGTGACGCTTTAGCAG: ATAGTGACGCTTTAGCAGT
GATATGGTAGGTGTGACTG: ATATGGTAGGTGTGACTGT
GATCAGTGGTCGAGCATGA: ATCAGTGGTCGAGCATGAA ATCAGTGGTCGAGCATGAC ATCAGTGGTCGAGCATGAG ATCAGTGGTCGAGCATGAG
GATCCGTGTCTATATTCGG: ATCCGTGTCTATATTCGGG
GATCCTCTCGGGAGCTCCT: ATCCTCTCGGGAGCTCCTA
GATCCTGGAAACTTGGAGG: ATCCTGGAAACTTGGAGGC
GATCGCGTAGGATCTGACA: ATCGCGTAGGATCTGACAG
GATCTAGTTTTACTCTGTA: ATCTAGTTTTACTCTGTAA
GATCTCATATCGGTTGCGA: ATCTCATATCGGTTGCGAT
GATCTCCTCTTGGTGCGTG: ATCTCCTCTTGGTGCGTGA
GATCTCCTGTATGACCCGA: ATCTCCTGTATGACCCGAT
GATCTCGGCAGAACATAGA: ATCTCGGCAGAACATAGAT
GATCTCTACGGTTCCTAGA: ATCTCTACGGTTCCTAGAT
GATCTGACAGCTGACCGCG: ATCTGACAGCTGACCGCGG
GATGACTCATTAAGCGGAC: ATGACTCATTAAGCGGACC
GATGCTCAAGGGGCTTGAC: ATGCTCAAGGGGCTTGACG
GATGGTATTCCAAACTTAA: ATGGTATTCCAAACTTAAA
GATGTCGTTCGAAAGCATA: ATGTCGTTCGAAAGCATAA
GATGTGACGAATGCCTTTG: ATGTGACGAATGCCTTTGC
GATGTGATCCTGGAAACTT: ATGTGATCCTGGAAACTTG
GATTATCGATATGGTAGGT: ATTATCGATATGGTAGGTG
GATTCTCGGTCAAAACTTA: ATTCTCGGTCAAAACTTAT
GATTCTGGTCTTTATAAGT: ATTCTGGTCTTTATAAGTT
GCAAACCCGTACAAGACAA: CAAACCCGTACAAGACAAA
GCAAAGCTAGCTAGGGGAT: CAAAGCTAGCTAGGGGATC
GCAATAACTGGAGTTTAGA: CAATAACTGGAGTTTAGAG
GCAATGATGTGACGAATGC: CAATGATGTGACGAATGCC
GCACAATACACCGTGGGAT: CACAATACACCGTGGGATC
GCACACGGCTTGGGCCACG: CACACGGCTTGGGCCACGG
GCACAGCGCCCGGGCCATT: CACAGCGCCCGGGCCATTA
GCACATCACGCATACATCT: CACATCACGCATACATCTA
GCACCGTAGTCAGTGACAT: CACCGTAGTCAGTGACATA
GCACGGCACAGCGCCCGGG: CACGGCACAGCGCCCGGGC
GCACGTCATCTTCCCACCT: CACGTCATCTTCCCACCTT
GCACGTCCAACATCACGAC: CACGTCCAACATCACGACA
GCACTATTTGCACACGGCT: CACTATTTGCACACGGCTT
GCACTTATGCCGACTAATA: CACTTATGCCGACTAATAG
GCAGAACATAGATCAGTGG: CAGAACATAGATCAGTGGT
GCAGATCTCATATCGGTTG: CAGATCTCATATCGGTTGC
GCAGATCTCCTGTATGACC: CAGATCTCCTGTATGACCC
GCAGATCTCGGCAGAACAT: CAGATCTCGGCAGAACATA
GCAGATCTCTACGGTTCCT: CAGATCTCTACGGTTCCTA
GCAGGTGAGACATTATCAA: CAGGTGAGACATTATCAAC
GCAGTGTAAAGAGTGGATA: CAGTGTAAAGAGTGGATAA
GCATAAATATTAACTCGCA: CATAAATATTAACTCGCAG
GCATACATCTATCCTGTGC: CATACATCTATCCTGTGCA
GCATACCCGAGGGCTGTTG: CATACCCGAGGGCTGTTGT
GCATCCGCACCGTAGTCAG: CATCCGCACCGTAGTCAGT
GCATCCGTGTCAACTGCGC: CATCCGTGTCAACTGCGCC
GCATCCTTTCGTGTGACCA: CATCCTTTCGTGTGACCAT
GCATCGCGATAAACATCGG: CATCGCGATAAACATCGGG
GCATGAAAGGCCAGCCGGT: CATGAAAGGCCAGCCGGTC
GCATGACGGTTGTTGGGGC: CATGACGGTTGTTGGGGCT
GCATGAGATGACTCATTAA: CATGAGATGACTCATTAAG
GCATGAGCCGAACTTTAAT: CATGAGCCGAACTTTAATT
GCATGCTTGCGCTGTGACC: CATGCTTGCGCTGTGACCA
GCATGGAATTCGAGTCCCT: CATGGAATTCGAGTCCCTG
GCATGTCCCGACACATATT: CATGTCCCGACACATATTG
GCATTGAGTACCTGTTGCT: CATTGAGTACCTGTTGCTT
GCCAAGCATGGAATTCGAG: CCAAGCATGGAATTCGAGT
GCCAAGCTGCCATCCCGGC: CCAAGCTGCCATCCCGGCT
GCCAATTTGAGCGACGTAA: CCAATTTGAGCGACGTAAG
GCCACCAACGCCTGTTATT: CCACCAACGCCTGTTATTA
GCCACGGTAAGACTTGGAA: CCACGGTAAGACTTGGAAA
GCCAGCATCCTTTCGTGTG: CCAGCATCCTTTCGTGTGA
GCCAGCCAAGCATGGAATT: CCAGCCAAGCATGGAATTC
GCCAGCCGGTCAACTTGTC: CCAGCCGGTCAACTTGTCG
GCCATATCGTGCTTATAAC: CCATATCGTGCTTATAACT
GCCATCCCGGCTGACAGCT: CCATCCCGGCTGACAGCTG
GCCATTAATTTCGGGGTCG: CCATTAATTTCGGGGTCGG
GCCATTGCCGACTTCAACA: CCATTGCCGACTTCAACAA
GCCCAATAAATTAGACTGC: CCCAATAAATTAGACTGCG
GCCCACCCGCATCCGTGTC: CCCACCCGCATCCGTGTCA
GCCCATTGATGTGATCCTG: CCCATTGATGTGATCCTGG
GCCCCACACTGCACGGCAC: CCCCACACTGCACGGCACA
GCCCGGGCCATTAATTTCG: CCCGGGCCATTAATTTCGG
GCCCGTTATAATTAATAAG: CCCGTTATAATTAATAAGA
GCCCTCACACTTCAAAGGC: CCCTCACACTTCAAAGGCC
GCCCTTTGATGCTCAAGGG: CCCTTTGATGCTCAAGGGG
GCCGAAACAGTTTGACCGA: CCGAAACAGTTTGACCGAC
GCCGAACTTTAATTAGATG: CCGAACTTTAATTAGATGG
GCCGACTAATAGGGTTGTA: CCGACTAATAGGGTTGTAA
GCCGACTTCAACAATTCTC: CCGACTTCAACAATTCTCG
GCCGAGACGCTAGTATCGT: CCGAGACGCTAGTATCGTA
GCCGCCCTCACACTTCAAA: CCGCCCTCACACTTCAAAG
GCCGCGCTGTTATGCTCTA: CCGCGCTGTTATGCTCTAA
GCCGCGGCGGGTGCCGAGA: CCGCGGCGGGTGCCGAGAC
GCCGCTCTCGCGATCGCGT: CCGCTCTCGCGATCGCGTA
GCCGCTGTATTCAATGATT: CCGCTGTATTCAATGATTC
GCCGGTCAACTTGTCGATA: CCGGTCAACTTGTCGATAG
GCCTAACGGGCGGGCTTAA: CCTAACGGGCGGGCTTAAG
GCCTACCCCACTCGTGAGT: CCTACCCCACTCGTGAGTA
GCCTACTACTTGCACGTCA: CCTACTACTTGCACGTCAT
GCCTCAGTTACGGCACTAT: CCTCAGTTACGGCACTATT
GCCTGCCACCAACGCCTGT: CCTGCCACCAACGCCTGTT
GCCTGCGCCAAGCTGCCAT: CCTGCGCCAAGCTGCCATC
GCCTGTTATTAACTCGCAG: CCTGTTATTAACTCGCAGA
GCCTTTGCCATTGCCGACT: CCTTTGCCATTGCCGACTT
GCCTTTGGGATACTTCCAG: CCTTTGGGATACTTCCAGC
GCGAACCCTAGGGGAAGTC: CGAACCCTAGGGGAAGTCC
GCGAAGCCGCCCTCACACT: CGAAGCCGCCCTCACACTT
GCGACGTAAGGGTAGAGTA: CGACGTAAGGGTAGAGTAT
GCGAGTTCTCTATTCGTGC: CGAGTTCTCTATTCGTGCG
GCGAGTTTCTTTAACGGCC: CGAGTTTCTTTAACGGCCG
GCGATAAACATCGGGGCGG: CGATAAACATCGGGGCGGG
GCGATCAGTGGTCGAGCAT: CGATCAGTGGTCGAGCATG
GCGATCGCGTAGGATCTGA: CGATCGCGTAGGATCTGAC
GCGCATCGCGATAAACATC: CGCATCGCGATAAACATCG
GCGCCAAGCTGCCATCCCG: CGCCAAGCTGCCATCCCGG
GCGCCCGGGCCATTAATTT: CGCCCGGGCCATTAATTTC
GCGCCCGTTATAATTAATA: CGCCCGTTATAATTAATAA
GCGCCGCTGTATTCAATGA: CGCCGCTGTATTCAATGAT
GCGCCTGCCACCAACGCCT: CGCCTGCCACCAACGCCTG
GCGCTATATCATATCGGAA: CGCTATATCATATCGGAAC
GCGCTGATGTCGTTCGAAA: CGCTGATGTCGTTCGAAAG
GCGCTGTGACCAGTTATAG: CGCTGTGACCAGTTATAGC
GCGCTGTTATGCTCTAATA: CGCTGTTATGCTCTAATAA
GCGGACCATCTTTCCCGCA: CGGACCATCTTTCCCGCAC
GCGGACGCGTCGGCCATAT: CGGACGCGTCGGCCATATC
GCGGCATACCCGAGGGCTG: CGGCATACCCGAGGGCTGT
GCGGCGGGTGCCGAGACGC: CGGCGGGTGCCGAGACGCT
GCGGCTACTCACTTCCTGT: CGGCTACTCACTTCCTGTA
GCGGGAAATACATGGCGCA: CGGGAAATACATGGCGCAT
GCGGGAACCTGCTCAATGG: CGGGAACCTGCTCAATGGC
GCGGGCACTTATGCCGACT: CGGGCACTTATGCCGACTA
GCGGGCGGGTCATCTGACA: CGGGCGGGTCATCTGACAA
GCGGGCTTAAGCTGTAACA: CGGGCTTAAGCTGTAACAG
GCGGGTCATCTGACAATTC: CGGGTCATCTGACAATTCT
GCGGGTGATTCTGGTCTTT: CGGGTGATTCTGGTCTTTA
GCGGGTGCCGAGACGCTAG: CGGGTGCCGAGACGCTAGT
GCGGTCGCGTATATAGGCC: CGGTCGCGTATATAGGCCC
GCGTAAATATACGCACAAT: CGTAAATATACGCACAATA
GCGTAGGATCTGACAGCTG: CGTAGGATCTGACAGCTGA
GCGTATATAGGCCCAATAA: CGTATATAGGCCCAATAAA
GCGTCACCCGGACGCCCAT: CGTCACCCGGACGCCCATT
GCGTCGGCCATATCGTGCT: CGTCGGCCATATCGTGCTT
GCGTGAAGTAGAACCCTCA: CGTGAAGTAGAACCCTCAT
GCGTGGTCGGTCCGTAGGT: CGTGGTCGGTCCGTAGGTG
GCGTTCGGACGCATTGAGT: CGTTCGGACGCATTGAGTA
GCGTTTATCATAATTAGCC: CGTTTATCATAATTAGCCT
GCTAATCGCGCCCGTTATA: CTAATCGCGCCCGTTATAA
GCTACTCACTTCCTGTATG: CTACTCACTTCCTGTATGT
GCTAGACGCGTAAATATAC: CTAGACGCGTAAATATACG
GCTAGATACTGTGAGCGCT: CTAGATACTGTGAGCGCTG
GCTAGCGTCACCCGGACGC: CTAGCGTCACCCGGACGCC
GCTAGCTAGGGGATCCTCT: CTAGCTAGGGGATCCTCTC
GCTAGGATAGTGACGCTTT: CTAGGATAGTGACGCTTTA
GCTAGGGGATCCTCTCGGG: CTAGGGGATCCTCTCGGGA
GCTAGTATCGTAGTCCACC: CTAGTATCGTAGTCCACCA
GCTATATCATATCGGAACG: CTATATCATATCGGAACGA
GCTCAAGGGGCTTGACGTG: CTCAAGGGGCTTGACGTGC
GCTCAATGGCCGCGCTGTT: CTCAATGGCCGCGCTGTTA
GCTCCCTTATGGACGAGCC: CTCCCTTATGGACGAGCCA
GCTCCTAATTGCTGTCATG: CTCCTAATTGCTGTCATGC
GCTCGGCTAATCGCGCCCG: CTCGGCTAATCGCGCCCGT
GCTCTAATAATACAGTGTA: CTCTAATAATACAGTGTAC
GCTCTCGCGATCGCGTAGG: CTCTCGCGATCGCGTAGGA
GCTCTTGAGAACTGCCCCA: CTCTTGAGAACTGCCCCAC
GCTGAACTGGCGGGAAATA: CTGAACTGGCGGGAAATAC
GCTGACAGCTGCCTTTGGG: CTGACAGCTGCCTTTGGGA
GCTGACCCTCGTCTTGGTA: CTGACCCTCGTCTTGGTAA
GCTGACCGCGGCATACCCG: CTGACCGCGGCATACCCGA
GCTGATGTCGTTCGAAAGC: CTGATGTCGTTCGAAAGCA
GCTGCCATCCCGGCTGACA: CTGCCATCCCGGCTGACAG
GCTGCCTTTGGGATACTTC: CTGCCTTTGGGATACTTCC
GCTGTAACAGGCTAGATAC: CTGTAACAGGCTAGATACT
GCTGTATTCAATGATTCTC: CTGTATTCAATGATTCTCG
GCTGTCATGCGAGTTCTCT: CTGTCATGCGAGTTCTCTA
GCTGTGACCAGTTATAGCT: CTGTGACCAGTTATAGCTC
GCTGTTATGCTCTAATAAT: CTGTTATGCTCTAATAATA
GCTGTTGTGACCCTTATCG: CTGTTGTGACCCTTATCGC
GCTTAAGCTGTAACAGGCT: CTTAAGCTGTAACAGGCTA
GCTTATAACTATTTACGGT: CTTATAACTATTTACGGTT
GCTTGACGTGCGAGTTTCT: CTTGACGTGCGAGTTTCTT
GCTTGCGCTGTGACCAGTT: CTTGCGCTGTGACCAGTTA
GCTTGGGCCACGGTAAGAC: CTTGGGCCACGGTAAGACT
GCTTTAGCAGTGTAAAGAG: CTTTAGCAGTGTAAAGAGT
GCTTTCAGGCTGAACTGGC: CTTTCAGGCTGAACTGGCG
GGAAACTTGGAGGCAATGA: GAAACTTGGAGGCAATGAT
GGAAATACATGGCGCATCG: GAAATACATGGCGCATCGC
GGAAATCCTCTTCACGCAC: GAAATCCTCTTCACGCACA
GGAACCTGCTCAATGGCCG: GAACCTGCTCAATGGCCGC
GGAACGAAGTAGAGCGGGT: GAACGAAGTAGAGCGGGTG
GGAAGAAAGGCTCGGCTAA: GAAGAAAGGCTCGGCTAAT
GGAAGTCCCAGCATGTCCC: GAAGTCCCAGCATGTCCCG
GGAATTCGAGTCCCTGCGG: GAATTCGAGTCCCTGCGGC
GGACCATCTTTCCCGCACG: GACCATCTTTCCCGCACGT
GGACCCTTCATACATCAAC: GACCCTTCATACATCAACA
GGACGAGCCAGCCAAGCAT: GACGAGCCAGCCAAGCATG
GGACGCATTGAGTACCTGT: GACGCATTGAGTACCTGTT
GGACGCCCATTGATGTGAT: GACGCCCATTGATGTGATC
GGACGCGTCGGCCATATCG: GACGCGTCGGCCATATCGT
GGAGCCTAACGGGCGGGCT: GAGCCTAACGGGCGGGCTT
GGAGCTCCTAATTGCTGTC: GAGCTCCTAATTGCTGTCA
GGAGGCAATGATGTGACGA: GAGGCAATGATGTGACGAA
GGAGTTTAGAGGAAGAAAG: GAGTTTAGAGGAAGAAAGG
GGATAAAAGCAAACCCGTA: GATAAAAGCAAACCCGTAC
GGATACTTCCAGCCTCAGT: GATACTTCCAGCCTCAGTT
GGATAGTGACGCTTTAGCA: GATAGTGACGCTTTAGCAG
GGATCCGTGTCTATATTCG: GATCCGTGTCTATATTCGG
GGATCCTCTCGGGAGCTCC: GATCCTCTCGGGAGCTCCT
GGATCTCCTCTTGGTGCGT: GATCTCCTCTTGGTGCGTG
GGATCTGACAGCTGACCGC: GATCTGACAGCTGACCGCG
GGATTATCGATATGGTAGG: GATTATCGATATGGTAGGT
GGCAATGATGTGACGAATG: GCAATGATGTGACGAATGC
GGCACAGCGCCCGGGCCAT: GCACAGCGCCCGGGCCATT
GGCACTATTTGCACACGGC: GCACTATTTGCACACGGCT
GGCACTTATGCCGACTAAT: GCACTTATGCCGACTAATA
GGCAGAACATAGATCAGTG: GCAGAACATAGATCAGTGG
GGCATACCCGAGGGCTGTT: GCATACCCGAGGGCTGTTG
GGCATCCGCACCGTAGTCA: GCATCCGCACCGTAGTCAG
GGCCACGGTAAGACTTGGA: GCCACGGTAAGACTTGGAA
GGCCAGCATCCTTTCGTGT: GCCAGCATCCTTTCGTGTG
GGCCAGCCGGTCAACTTGT: GCCAGCCGGTCAACTTGTC
GGCCATATCGTGCTTATAA: GCCATATCGTGCTTATAAC
GGCCATTAATTTCGGGGTC: GCCATTAATTTCGGGGTCG
GGCCCAATAAATTAGACTG: GCCCAATAAATTAGACTGC
GGCCGAAACAGTTTGACCG: GCCGAAACAGTTTGACCGA
GGCCGCGCTGTTATGCTCT: GCCGCGCTGTTATGCTCTA
GGCCGCGGCGGGTGCCGAG: GCCGCGGCGGGTGCCGAGA
GGCCGCTCTCGCGATCGCG: GCCGCTCTCGCGATCGCGT
GGCCTGCGCCAAGCTGCCA: GCCTGCGCCAAGCTGCCAT
GGCGCATCGCGATAAACAT: GCGCATCGCGATAAACATC
GGCGGACGCGTCGGCCATA: GCGGACGCGTCGGCCATAT
GGCGGGAAATACATGGCGC: GCGGGAAATACATGGCGCA
GGCGGGAACCTGCTCAATG: GCGGGAACCTGCTCAATGG
GGCGGGCACTTATGCCGAC: GCGGGCACTTATGCCGACT
GGCGGGCTTAAGCTGTAAC: GCGGGCTTAAGCTGTAACA
GGCGGGTCATCTGACAATT: GCGGGTCATCTGACAATTC
GGCGGGTGCCGAGACGCTA: GCGGGTGCCGAGACGCTAG
GGCGTTTATCATAATTAGC: GCGTTTATCATAATTAGCC
GGCTAATCGCGCCCGTTAT: GCTAATCGCGCCCGTTATA
GGCTACTCACTTCCTGTAT: GCTACTCACTTCCTGTATG
GGCTAGATACTGTGAGCGC: GCTAGATACTGTGAGCGCT
GGCTCGGCTAATCGCGCCC: GCTCGGCTAATCGCGCCCG
GGCTGAACTGGCGGGAAAT: GCTGAACTGGCGGGAAATA
GGCTGACAGCTGCCTTTGG: GCTGACAGCTGCCTTTGGG
GGCTGACCCTCGTCTTGGT: GCTGACCCTCGTCTTGGTA
GGCTGTTGTGACCCTTATC: GCTGTTGTGACCCTTATCG
GGCTTAAGCTGTAACAGGC: GCTTAAGCTGTAACAGGCT
GGCTTGACGTGCGAGTTTC: GCTTGACGTGCGAGTTTCT
GGCTTGGGCCACGGTAAGA: GCTTGGGCCACGGTAAGAC
GGGAAATACATGGCGCATC: GGAAATACATGGCGCATCG
GGGAACCTGCTCAATGGCC: GGAACCTGCTCAATGGCCG
GGGAAGTCCCAGCATGTCC: GGAAGTCCCAGCATGTCCC
GGGACCCTTCATACATCAA: GGACCCTTCATACATCAAC
GGGAGCCTAACGGGCGGGC: GGAGCCTAACGGGCGGGCT
GGGAGCTCCTAATTGCTGT: GGAGCTCCTAATTGCTGTC
GGGATACTTCCAGCCTCAG: GGATACTTCCAGCCTCAGT
GGGATCCGTGTCTATATTC: GGATCCGTGTCTATATTCG
GGGATCCTCTCGGGAGCTC: GGATCCTCTCGGGAGCTCC
GGGATTATCGATATGGTAG: GGATTATCGATATGGTAGG
GGGCACTTATGCCGACTAA: GGCACTTATGCCGACTAAT
GGGCCACGGTAAGACTTGG: GGCCACGGTAAGACTTGGA
GGGCCATTAATTTCGGGGT: GGCCATTAATTTCGGGGTC
GGGCCGCGGCGGGTGCCGA: GGCCGCGGCGGGTGCCGAG
GGGCGGGAACCTGCTCAAT: GGCGGGAACCTGCTCAATG
GGGCGGGCTTAAGCTGTAA: GGCGGGCTTAAGCTGTAAC
GGGCGGGTCATCTGACAAT: GGCGGGTCATCTGACAATT
GGGCTGACCCTCGTCTTGG: GGCTGACCCTCGTCTTGGT
GGGCTGTTGTGACCCTTAT: GGCTGTTGTGACCCTTATC
GGGCTTAAGCTGTAACAGG: GGCTTAAGCTGTAACAGGC
GGGCTTGACGTGCGAGTTT: GGCTTGACGTGCGAGTTTC
GGGGAAGTCCCAGCATGTC: GGGAAGTCCCAGCATGTCC
GGGGACCCTTCATACATCA: GGGACCCTTCATACATCAA
GGGGATCCTCTCGGGAGCT: GGGATCCTCTCGGGAGCTC
GGGGCGGGAACCTGCTCAA: GGGCGGGAACCTGCTCAAT
GGGGCTGACCCTCGTCTTG: GGGCTGACCCTCGTCTTGG
GGGGCTTGACGTGCGAGTT: GGGCTTGACGTGCGAGTTT
GGGGGACCCTTCATACATC: GGGGACCCTTCATACATCA
GGGGTATTAACTCGCAGAT: GGGTATTAACTCGCAGATC
GGGGTCGGGTCCCGGGGTA: GGGTCGGGTCCCGGGGTAT
GGGTAGAGTATACCTACAG: GGTAGAGTATACCTACAGA
GGGTATCATTGCAGGTGAG: GGTATCATTGCAGGTGAGA
GGGTATTAACTCGCAGATC: GGTATTAACTCGCAGATCT
GGGTCATCTGACAATTCTA: GGTCATCTGACAATTCTAG
GGGTCCCGGGGTATTAACT: GGTCCCGGGGTATTAACTC
GGGTCGGGTCCCGGGGTAT: GGTCGGGTCCCGGGGTATT
GGGTGATTCTGGTCTTTAT: GGTGATTCTGGTCTTTATA
GGGTGCCGAGACGCTAGTA: GGTGCCGAGACGCTAGTAT
GGGTTGTAACGTAACGATA: GGTTGTAACGTAACGATAG
GGTAAGACTTGGAAATCCT: GTAAGACTTGGAAATCCTC
GGTAAGCGAACCCTAGGGG: GTAAGCGAACCCTAGGGGA
GGTAGAGTATACCTACAGA: GTAGAGTATACCTACAGAA
GGTAGGTGTGACTGTAATC: GTAGGTGTGACTGTAATCG
GGTATCATTGCAGGTGAGA: GTATCATTGCAGGTGAGAC
GGTATTAACTCGCAGATCT: GTATTAACTCGCAGATCTC
GGTCAAAACTTATACACGC: GTCAAAACTTATACACGCC
GGTCAACTTGTCGATAGGC: GTCAACTTGTCGATAGGCG
GGTCATCTGACAATTCTAG: GTCATCTGACAATTCTAGG
GGTCCCGGGGTATTAACTC: GTCCCGGGGTATTAACTCG
GGTCCGTAGGTGGATCTCC: GTCCGTAGGTGGATCTCCT
GGTCGAGCATGAAAGGCCA: GTCGAGCATGAAAGGCCAG
GGTCGAGCATGACGGTTGT: GTCGAGCATGACGGTTGTT
GGTCGAGCATGAGATGACT: GTCGAGCATGAGATGACTC
GGTCGAGCATGAGCCGAAC: GTCGAGCATGAGCCGAACT
GGTCGCGTATATAGGCCCA: GTCGCGTATATAGGCCCAA
GGTCGGGTCCCGGGGTATT: GTCGGGTCCCGGGGTATTA
GGTCGGTCCGTAGGTGGAT: GTCGGTCCGTAGGTGGATC
GGTCTAAGCGCCTGCCACC: GTCTAAGCGCCTGCCACCA
GGTCTTTATAAGTTTGAGT: GTCTTTATAAGTTTGAGTG
GGTGAGACATTATCAACTA: GTGAGACATTATCAACTAT
GGTGATTCTGGTCTTTATA: GTGATTCTGGTCTTTATAA
GGTGCCGAGACGCTAGTAT: GTGCCGAGACGCTAGTATC
GGTGCGTGAAGTAGAACCC: GTGCGTGAAGTAGAACCCT
GGTGGATCTCCTCTTGGTG: GTGGATCTCCTCTTGGTGC
GGTGTGACTGTAATCGGCG: GTGTGACTGTAATCGGCGT
GGTTATGCCCACCCGCATC: GTTATGCCCACCCGCATCC
GGTTCCTAGATCAGTGGTC: GTTCCTAGATCAGTGGTCG
GGTTGCGATCAGTGGTCGA: GTTGCGATCAGTGGTCGAG
GGTTGTAACGTAACGATAG: GTTGTAACGTAACGATAGC
GGTTGTTGGGGCTGACCCT: GTTGTTGGGGCTGACCCTC
GTAAACGGTCTAAGCGCCT: TAAACGGTCTAAGCGCCTG
GTAAAGAGTGGATAAAAGC: TAAAGAGTGGATAAAAGCA
GTAAATATACGCACAATAC: TAAATATACGCACAATACA
GTAACAGGCTAGATACTGT: TAACAGGCTAGATACTGTG
GTAACGATAGCGAAGCCGC: TAACGATAGCGAAGCCGCC
GTAACGTAACGATAGCGAA: TAACGTAACGATAGCGAAG
GTAAGACTTGGAAATCCTC: TAAGACTTGGAAATCCTCT
GTAAGCGAACCCTAGGGGA: TAAGCGAACCCTAGGGGAA
GTAAGGGTAGAGTATACCT: TAAGGGTAGAGTATACCTA
GTAAGTCGGGTATCATTGC: TAAGTCGGGTATCATTGCA
GTAATCGGCGTTTATCATA: TAATCGGCGTTTATCATAA
GTACAAGACAAAAGAGGGG: TACAAGACAAAAGAGGGGG
GTACACACGAATCTGAATG: TACACACGAATCTGAATGG
GTACATTCACAAGCGTTCG: TACATTCACAAGCGTTCGG
GTACCTGTTGCTTTCAGGC: TACCTGTTGCTTTCAGGCT
GTAGAACCCTCATTTTATC: TAGAACCCTCATTTTATCT
GTAGAGCGGGTGATTCTGG: TAGAGCGGGTGATTCTGGT
GTAGAGTATACCTACAGAA: TAGAGTATACCTACAGAAC
GTAGGATCTGACAGCTGAC: TAGGATCTGACAGCTGACC
GTAGGTGGATCTCCTCTTG: TAGGTGGATCTCCTCTTGG
GTAGGTGTGACTGTAATCG: TAGGTGTGACTGTAATCGG
GTAGTCAGTGACATATTAT: TAGTCAGTGACATATTATC
GTAGTCCACCATAATCTTC: TAGTCCACCATAATCTTCC
GTATAACACCCAATATCTG: TATAACACCCAATATCTGA
GTATACCTACAGAACAGAA: TATACCTACAGAACAGAAC
GTATATAGGCCCAATAAAT: TATATAGGCCCAATAAATT
GTATCATTGCAGGTGAGAC: TATCATTGCAGGTGAGACA
GTATCGTAGTCCACCATAA: TATCGTAGTCCACCATAAT
GTATGACCCGATCAGTGGT: TATGACCCGATCAGTGGTC
GTATGTAAGTCGGGTATCA: TATGTAAGTCGGGTATCAT
GTATTAACTCGCAGATCTC: TATTAACTCGCAGATCTCG
GTATTCAATGATTCTCGGT: TATTCAATGATTCTCGGTC
GTCAAAACTTATACACGCC: TCAAAACTTATACACGCCA
GTCAACTGCGCCGCTGTAT: TCAACTGCGCCGCTGTATT
GTCAACTTGTCGATAGGCG: TCAACTTGTCGATAGGCGG
GTCACCCGGACGCCCATTG: TCACCCGGACGCCCATTGA
GTCAGTGACATATTATCGC: TCAGTGACATATTATCGCT
GTCATCTGACAATTCTAGG: TCATCTGACAATTCTAGGC
GTCATCTTCCCACCTTTAT: TCATCTTCCCACCTTTATC
GTCATGCGAGTTCTCTATT: TCATGCGAGTTCTCTATTC
GTCCAACATCACGACATGA: TCCAACATCACGACATGAA
GTCCACCATAATCTTCCAA: TCCACCATAATCTTCCAAC
GTCCATATGGCCAGCATCC: TCCATATGGCCAGCATCCT
GTCCCAGCATGTCCCGACA: TCCCAGCATGTCCCGACAC
GTCCCGACACATATTGTCG: TCCCGACACATATTGTCGC
GTCCCGGGGTATTAACTCG: TCCCGGGGTATTAACTCGC
GTCCCTGCGGCTACTCACT: TCCCTGCGGCTACTCACTT
GTCCGTAGGTGGATCTCCT: TCCGTAGGTGGATCTCCTC
GTCGAGCATGAAAGGCCAG: TCGAGCATGAAAGGCCAGC
GTCGAGCATGACGGTTGTT: TCGAGCATGACGGTTGTTG
GTCGAGCATGAGATGACTC: TCGAGCATGAGATGACTCA
GTCGAGCATGAGCCGAACT: TCGAGCATGAGCCGAACTT
GTCGATAGGCGGACGCGTC: TCGATAGGCGGACGCGTCG
GTCGCGTATATAGGCCCAA: TCGCGTATATAGGCCCAAT
GTCGCTAGCGTCACCCGGA: TCGCTAGCGTCACCCGGAC
GTCGGCCATATCGTGCTTA: TCGGCCATATCGTGCTTAT
GTCGGGTATCATTGCAGGT: TCGGGTATCATTGCAGGTG
GTCGGGTCCCGGGGTATTA: TCGGGTCCCGGGGTATTAA
GTCGGTCCGTAGGTGGATC: TCGGTCCGTAGGTGGATCT
GTCGTTCGAAAGCATAAAT: TCGTTCGAAAGCATAAATA
GTCTAAGCGCCTGCCACCA: TCTAAGCGCCTGCCACCAA
GTCTATATTCGGGAGCCTA: TCTATATTCGGGAGCCTAA
GTCTTGGTAAGCGAACCCT: TCTTGGTAAGCGAACCCTA
GTCTTTATAAGTTTGAGTG: TCTTTATAAGTTTGAGTGA
GTGAAGGCCGCTCTCGCGA: TGAAGGCCGCTCTCGCGAT
GTGAAGTAGAACCCTCATT: TGAAGTAGAACCCTCATTT
GTGACATATTATCGCTAGG: TGACATATTATCGCTAGGA
GTGACCAGTTATAGCTCCC: TGACCAGTTATAGCTCCCT
GTGACCATATTACGCGGTC: TGACCATATTACGCGGTCG
GTGACCCTTATCGCATGCT: TGACCCTTATCGCATGCTT
GTGACGAATGCCTTTGCCA: TGACGAATGCCTTTGCCAT
GTGACGCTTTAGCAGTGTA: TGACGCTTTAGCAGTGTAA
GTGACTGTAATCGGCGTTT: TGACTGTAATCGGCGTTTA
GTGAGACATTATCAACTAT: TGAGACATTATCAACTATT
GTGAGCGCTGATGTCGTTC: TGAGCGCTGATGTCGTTCG
GTGAGGGCCGCGGCGGGTG: TGAGGGCCGCGGCGGGTGC
GTGAGTATAACACCCAATA: TGAGTATAACACCCAATAT
GTGATCCTGGAAACTTGGA: TGATCCTGGAAACTTGGAG
GTGATTCTGGTCTTTATAA: TGATTCTGGTCTTTATAAG
GTGCAAAGCTAGCTAGGGG: TGCAAAGCTAGCTAGGGGA
GTGCCGAGACGCTAGTATC: TGCCGAGACGCTAGTATCG
GTGCGAGTTTCTTTAACGG: TGCGAGTTTCTTTAACGGC
GTGCGTGAAGTAGAACCCT: TGCGTGAAGTAGAACCCTC
GTGCGTGGTCGGTCCGTAG: TGCGTGGTCGGTCCGTAGG
GTGCTTATAACTATTTACG: TGCTTATAACTATTTACGG
GTGGATAAAAGCAAACCCG: TGGATAAAAGCAAACCCGT
GTGGATCTCCTCTTGGTGC: TGGATCTCCTCTTGGTGCG
GTGGGATCCGTGTCTATAT: TGGGATCCGTGTCTATATT
GTGGTCGAGCATGAAAGGC: TGGTCGAGCATGAAAGGCC
GTGGTCGAGCATGACGGTT: TGGTCGAGCATGACGGTTG
GTGGTCGAGCATGAGATGA: TGGTCGAGCATGAGATGAC
GTGGTCGAGCATGAGCCGA: TGGTCGAGCATGAGCCGAA
GTGGTCGGTCCGTAGGTGG: TGGTCGGTCCGTAGGTGGA
GTGTAAAGAGTGGATAAAA: TGTAAAGAGTGGATAAAAG
GTGTACACACGAATCTGAA: TGTACACACGAATCTGAAT
GTGTACATTCACAAGCGTT: TGTACATTCACAAGCGTTC
GTGTCAACTGCGCCGCTGT: TGTCAACTGCGCCGCTGTA
GTGTCTATATTCGGGAGCC: TGTCTATATTCGGGAGCCT
GTGTGACCATATTACGCGG: TGTGACCATATTACGCGGT
GTGTGACTGTAATCGGCGT: TGTGACTGTAATCGGCGTT
GTTACGGCACTATTTGCAC: TTACGGCACTATTTGCACA
GTTATAATTAATAAGAATC: TTATAATTAATAAGAATCT
GTTATAGCTCCCTTATGGA: TTATAGCTCCCTTATGGAC
GTTATGCCCACCCGCATCC: TTATGCCCACCCGCATCCG
GTTATGCTCTAATAATACA: TTATGCTCTAATAATACAG
GTTATTAACTCGCAGATCT: TTATTAACTCGCAGATCTC
GTTCCTAGATCAGTGGTCG: TTCCTAGATCAGTGGTCGA
GTTCGAAAGCATAAATATT: TTCGAAAGCATAAATATTA
GTTCGGACGCATTGAGTAC: TTCGGACGCATTGAGTACC
GTTCTCTATTCGTGCGTGG: TTCTCTATTCGTGCGTGGT
GTTGCGATCAGTGGTCGAG: TTGCGATCAGTGGTCGAGC
GTTGCTTTCAGGCTGAACT: TTGCTTTCAGGCTGAACTG
GTTGGGGCTGACCCTCGTC: TTGGGGCTGACCCTCGTCT
GTTGTAACGTAACGATAGC: TTGTAACGTAACGATAGCG
GTTGTGACCCTTATCGCAT: TTGTGACCCTTATCGCATG
GTTGTTGGGGCTGACCCTC: TTGTTGGGGCTGACCCTCG
GTTTAGAGGAAGAAAGGCT: TTTAGAGGAAGAAAGGCTC
GTTTATCATAATTAGCCTA: TTTATCATAATTAGCCTAC
GTTTCTTTAACGGCCGAAA: TTTCTTTAACGGCCGAAAC
GTTTGACCGACTCGTCCAT: TTTGACCGACTCGTCCATA
GTTTGAGTGAAGGCCGCTC: TTTGAGTGAAGGCCGCTCT
GTTTTACTCTGTAAACGGT: TTTTACTCTGTAAACGGTC
TAAAAGCAAACCCGTACAA: AAAAGCAAACCCGTACAAG
TAAACATCGGGGCGGGAAC: AAACATCGGGGCGGGAACC
TAAACGGTCTAAGCGCCTG: AAACGGTCTAAGCGCCTGC
TAAAGAGTGGATAAAAGCA: AAAGAGTGGATAAAAGCAA
TAAATATACGCACAATACA: AAATATACGCACAATACAC
TAAATATTAACTCGCAGAT: AAATATTAACTCGCAGATC
TAAATTAGACTGCGGGCGG: AAATTAGACTGCGGGCGGG
TAACACCCAATATCTGACG: AACACCCAATATCTGACGG
TAACAGGCTAGATACTGTG: AACAGGCTAGATACTGTGA
TAACGATAGCGAAGCCGCC: AACGATAGCGAAGCCGCCC
TAACGGCCGAAACAGTTTG: AACGGCCGAAACAGTTTGA
TAACGGGCGGGCTTAAGCT: AACGGGCGGGCTTAAGCTG
TAACGTAACGATAGCGAAG: AACGTAACGATAGCGAAGC
TAACTATTTACGGTTATGC: AACTATTTACGGTTATGCC
TAACTCGCAGATCTCATAT: AACTCGCAGATCTCATATC
TAACTCGCAGATCTCCTGT: AACTCGCAGATCTCCTGTA
TAACTCGCAGATCTCGGCA: AACTCGCAGATCTCGGCAG
TAACTCGCAGATCTCTACG: AACTCGCAGATCTCTACGG
TAACTGGAGTTTAGAGGAA: AACTGGAGTTTAGAGGAAG
TAAGAATCTATCGTGTACA: AAGAATCTATCGTGTACAT
TAAGACTTGGAAATCCTCT: AAGACTTGGAAATCCTCTT
TAAGCGAACCCTAGGGGAA: AAGCGAACCCTAGGGGAAG
TAAGCGCCTGCCACCAACG: AAGCGCCTGCCACCAACGC
TAAGCGGACCATCTTTCCC: AAGCGGACCATCTTTCCCG
TAAGCTGTAACAGGCTAGA: AAGCTGTAACAGGCTAGAT
TAAGGGTAGAGTATACCTA: AAGGGTAGAGTATACCTAC
TAAGTCGGGTATCATTGCA: AAGTCGGGTATCATTGCAG
TAAGTTTGAGTGAAGGCCG: AAGTTTGAGTGAAGGCCGC
TAATAAGAATCTATCGTGT: AATAAGAATCTATCGTGTA
TAATAATACAGTGTACACA: AATAATACAGTGTACACAC
TAATACAGTGTACACACGA: AATACAGTGTACACACGAA
TAATAGGGTTGTAACGTAA: AATAGGGTTGTAACGTAAC
TAATCGCGCCCGTTATAAT: AATCGCGCCCGTTATAATT
TAATCGGCGTTTATCATAA: AATCGGCGTTTATCATAAT
TAATCTTCCAACATTTACA: AATCTTCCAACATTTACAG
TAATTAATAAGAATCTATC: AATTAATAAGAATCTATCG
TAATTAGATGGTATTCCAA: AATTAGATGGTATTCCAAA
TAATTAGCCTACTACTTGC: AATTAGCCTACTACTTGCA
TAATTGCTGTCATGCGAGT: AATTGCTGTCATGCGAGTT
TAATTTCGGGGTCGGGTCC: AATTTCGGGGTCGGGTCCC
TACAAGACAAAAGAGGGGG: ACAAGACAAAAGAGGGGGA
TACACACGAATCTGAATGG: ACACACGAATCTGAATGGG
TACACCGTGGGATCCGTGT: ACACCGTGGGATCCGTGTC
TACACGCCAATTTGAGCGA: ACACGCCAATTTGAGCGAC
TACAGAACAGAACGCAATA: ACAGAACAGAACGCAATAA
TACAGATCTAGTTTTACTC: ACAGATCTAGTTTTACTCT
TACAGTGTACACACGAATC: ACAGTGTACACACGAATCT
TACATCAACAAGCTAGACG: ACATCAACAAGCTAGACGC
TACATCTATCCTGTGCAAA: ACATCTATCCTGTGCAAAG
TACATGGCGCATCGCGATA: ACATGGCGCATCGCGATAA
TACATTCACAAGCGTTCGG: ACATTCACAAGCGTTCGGA
TACCCCACTCGTGAGTATA: ACCCCACTCGTGAGTATAA
TACCCGAGGGCTGTTGTGA: ACCCGAGGGCTGTTGTGAC
TACCTACAGAACAGAACGC: ACCTACAGAACAGAACGCA
TACCTGTTGCTTTCAGGCT: ACCTGTTGCTTTCAGGCTG
TACGCACAATACACCGTGG: ACGCACAATACACCGTGGG
TACGCGGTCGCGTATATAG: ACGCGGTCGCGTATATAGG
TACGGCACTATTTGCACAC: ACGGCACTATTTGCACACG
TACGGTTATGCCCACCCGC: ACGGTTATGCCCACCCGCA
TACGGTTCCTAGATCAGTG: ACGGTTCCTAGATCAGTGG
TACTACTTGCACGTCATCT: ACTACTTGCACGTCATCTT
TACTCACTTCCTGTATGTA: ACTCACTTCCTGTATGTAA
TACTCTGTAAACGGTCTAA: ACTCTGTAAACGGTCTAAG
TACTGTGAGCGCTGATGTC: ACTGTGAGCGCTGATGTCG
TACTTCCAGCCTCAGTTAC: ACTTCCAGCCTCAGTTACG
TACTTGCACGTCATCTTCC: ACTTGCACGTCATCTTCCC
TAGAACCCTCATTTTATCT: AGAACCCTCATTTTATCTC
TAGACGCGTAAATATACGC: AGACGCGTAAATATACGCA
TAGACTGCGGGCGGGTCAT: AGACTGCGGGCGGGTCATC
TAGAGCGGGTGATTCTGGT: AGAGCGGGTGATTCTGGTC
TAGAGGAAGAAAGGCTCGG: AGAGGAAGAAAGGCTCGGC
TAGAGTATACCTACAGAAC: AGAGTATACCTACAGAACA
TAGATACTGTGAGCGCTGA: AGATACTGTGAGCGCTGAT
TAGATCAGTGGTCGAGCAT: AGATCAGTGGTCGAGCATG AGATCAGTGGTCGAGCATG
TAGATGGTATTCCAAACTT: AGATGGTATTCCAAACTTA
TAGCAGTGTAAAGAGTGGA: AGCAGTGTAAAGAGTGGAT
TAGCCTACTACTTGCACGT: AGCCTACTACTTGCACGTC
TAGCGAAGCCGCCCTCACA: AGCGAAGCCGCCCTCACAC
TAGCGTCACCCGGACGCCC: AGCGTCACCCGGACGCCCA
TAGCTAGGGGATCCTCTCG: AGCTAGGGGATCCTCTCGG
TAGCTCCCTTATGGACGAG: AGCTCCCTTATGGACGAGC
TAGGATAGTGACGCTTTAG: AGGATAGTGACGCTTTAGC
TAGGATCTGACAGCTGACC: AGGATCTGACAGCTGACCG
TAGGCATCCGCACCGTAGT: AGGCATCCGCACCGTAGTC
TAGGCCCAATAAATTAGAC: AGGCCCAATAAATTAGACT
TAGGCGGACGCGTCGGCCA: AGGCGGACGCGTCGGCCAT
TAGGGGAAGTCCCAGCATG: AGGGGAAGTCCCAGCATGT
TAGGGGATCCTCTCGGGAG: AGGGGATCCTCTCGGGAGC
TAGGGTTGTAACGTAACGA: AGGGTTGTAACGTAACGAT
TAGGTGGATCTCCTCTTGG: AGGTGGATCTCCTCTTGGT
TAGGTGTGACTGTAATCGG: AGGTGTGACTGTAATCGGC
TAGTATCGTAGTCCACCAT: AGTATCGTAGTCCACCATA
TAGTCAGTGACATATTATC: AGTCAGTGACATATTATCG
TAGTCCACCATAATCTTCC: AGTCCACCATAATCTTCCA
TAGTGACGCTTTAGCAGTG: AGTGACGCTTTAGCAGTGT
TAGTTTTACTCTGTAAACG: AGTTTTACTCTGTAAACGG
TATAACACCCAATATCTGA: ATAACACCCAATATCTGAC
TATAACTATTTACGGTTAT: ATAACTATTTACGGTTATG
TATAAGTTTGAGTGAAGGC: ATAAGTTTGAGTGAAGGCC
TATAATTAATAAGAATCTA: ATAATTAATAAGAATCTAT
TATACACGCCAATTTGAGC: ATACACGCCAATTTGAGCG
TATACCTACAGAACAGAAC: ATACCTACAGAACAGAACG
TATACGCACAATACACCGT: ATACGCACAATACACCGTG
TATAGCTCCCTTATGGACG: ATAGCTCCCTTATGGACGA
TATAGGCCCAATAAATTAG: ATAGGCCCAATAAATTAGA
TATATAGGCCCAATAAATT: ATATAGGCCCAATAAATTA
TATATCATATCGGAACGAA: ATATCATATCGGAACGAAG
TATATTCGGGAGCCTAACG: ATATTCGGGAGCCTAACGG
TATCAACTATTAACTCGCA: ATCAACTATTAACTCGCAG
TATCATAATTAGCCTACTA: ATCATAATTAGCCTACTAC
TATCATATCGGAACGAAGT: ATCATATCGGAACGAAGTA
TATCATTGCAGGTGAGACA: ATCATTGCAGGTGAGACAT
TATCCAATTGACGCCCTTT: ATCCAATTGACGCCCTTTG
TATCCGACCACAGAGTGAG: ATCCGACCACAGAGTGAGG
TATCCTGTGCAAAGCTAGC: ATCCTGTGCAAAGCTAGCT
TATCGATATGGTAGGTGTG: ATCGATATGGTAGGTGTGA
TATCGCATGCTTGCGCTGT: ATCGCATGCTTGCGCTGTG
TATCGCTAGGATAGTGACG: ATCGCTAGGATAGTGACGC
TATCGGAACGAAGTAGAGC: ATCGGAACGAAGTAGAGCG
TATCGGTTGCGATCAGTGG: ATCGGTTGCGATCAGTGGT
TATCGTAGTCCACCATAAT: ATCGTAGTCCACCATAATC
TATCGTGCTTATAACTATT: ATCGTGCTTATAACTATTT
TATCGTGTACATTCACAAG: ATCGTGTACATTCACAAGC
TATCTCATATCCGACCACA: ATCTCATATCCGACCACAG
TATCTGACGGCGGGCACTT: ATCTGACGGCGGGCACTTA
TATGACCCGATCAGTGGTC: ATGACCCGATCAGTGGTCG
TATGCCCACCCGCATCCGT: ATGCCCACCCGCATCCGTG
TATGCCGACTAATAGGGTT: ATGCCGACTAATAGGGTTG
TATGCTCTAATAATACAGT: ATGCTCTAATAATACAGTG
TATGGACGAGCCAGCCAAG: ATGGACGAGCCAGCCAAGC
TATGGCCAGCATCCTTTCG: ATGGCCAGCATCCTTTCGT
TATGGTAGGTGTGACTGTA: ATGGTAGGTGTGACTGTAA
TATGTAAGTCGGGTATCAT: ATGTAAGTCGGGTATCATT
TATTAACTCGCAGATCTCA: ATTAACTCGCAGATCTCAT
TATTAACTCGCAGATCTCC: ATTAACTCGCAGATCTCCT
TATTAACTCGCAGATCTCG: ATTAACTCGCAGATCTCGG
TATTAACTCGCAGATCTCT: ATTAACTCGCAGATCTCTA
TATTACGCGGTCGCGTATA: ATTACGCGGTCGCGTATAT
TATTATCGCTAGGATAGTG: ATTATCGCTAGGATAGTGA
TATTCAATGATTCTCGGTC: ATTCAATGATTCTCGGTCA
TATTCGGGAGCCTAACGGG: ATTCGGGAGCCTAACGGGC
TATTCGTGCGTGGTCGGTC: ATTCGTGCGTGGTCGGTCC
TATTGTCGCTAGCGTCACC: ATTGTCGCTAGCGTCACCC
TATTTACGGTTATGCCCAC: ATTTACGGTTATGCCCACC
TATTTGCACACGGCTTGGG: ATTTGCACACGGCTTGGGC
TCAAAACTTATACACGCCA: CAAAACTTATACACGCCAA
TCAAAGGCCTGCGCCAAGC: CAAAGGCCTGCGCCAAGCT
TCAACAAGCTAGACGCGTA: CAACAAGCTAGACGCGTAA
TCAACAATTCTCGCCTACC: CAACAATTCTCGCCTACCC
TCAACTATTAACTCGCAGA: CAACTATTAACTCGCAGAT
TCAACTGCGCCGCTGTATT: CAACTGCGCCGCTGTATTC
TCAACTTGTCGATAGGCGG: CAACTTGTCGATAGGCGGA
TCAAGGGGCTTGACGTGCG: CAAGGGGCTTGACGTGCGA
TCAATGATTCTCGGTCAAA: CAATGATTCTCGGTCAAAA
TCAATGGCCGCGCTGTTAT: CAATGGCCGCGCTGTTATG
TCACAAGCGTTCGGACGCA: CACAAGCGTTCGGACGCAT
TCACACTTCAAAGGCCTGC: CACACTTCAAAGGCCTGCG
TCACCCGGACGCCCATTGA: CACCCGGACGCCCATTGAT
TCACGACATGAATGCTCTT: CACGACATGAATGCTCTTG
TCACGCACATCACGCATAC: CACGCACATCACGCATACA
TCACGCATACATCTATCCT: CACGCATACATCTATCCTG
TCACTTCCTGTATGTAAGT: CACTTCCTGTATGTAAGTC
TCAGGCTGAACTGGCGGGA: CAGGCTGAACTGGCGGGAA
TCAGTGACATATTATCGCT: CAGTGACATATTATCGCTA
TCAGTGGTCGAGCATGAAA: CAGTGGTCGAGCATGAAAG
TCAGTGGTCGAGCATGACG: CAGTGGTCGAGCATGACGG
TCAGTGGTCGAGCATGAGA: CAGTGGTCGAGCATGAGAT
TCAGTGGTCGAGCATGAGC: CAGTGGTCGAGCATGAGCC
TCAGTTACGGCACTATTTG: CAGTTACGGCACTATTTGC
TCATAATTAGCCTACTACT: CATAATTAGCCTACTACTT
TCATACATCAACAAGCTAG: CATACATCAACAAGCTAGA
TCATATCCGACCACAGAGT: CATATCCGACCACAGAGTG
TCATATCGGAACGAAGTAG: CATATCGGAACGAAGTAGA
TCATATCGGTTGCGATCAG: CATATCGGTTGCGATCAGT
TCATCTGACAATTCTAGGC: CATCTGACAATTCTAGGCA
TCATCTTCCCACCTTTATC: CATCTTCCCACCTTTATCC
TCATGCGAGTTCTCTATTC: CATGCGAGTTCTCTATTCG
TCATTAAGCGGACCATCTT: CATTAAGCGGACCATCTTT
TCATTGCAGGTGAGACATT: CATTGCAGGTGAGACATTA
TCATTTTATCTCATATCCG: CATTTTATCTCATATCCGA
TCCAACATCACGACATGAA: CCAACATCACGACATGAAT
TCCAACATTTACAGATCTA: CCAACATTTACAGATCTAG
TCCAATTGACGCCCTTTGA: CCAATTGACGCCCTTTGAT
TCCACCATAATCTTCCAAC: CCACCATAATCTTCCAACA
TCCAGCCTCAGTTACGGCA: CCAGCCTCAGTTACGGCAC
TCCATATGGCCAGCATCCT: CCATATGGCCAGCATCCTT
TCCCACCTTTATCCAATTG: CCCACCTTTATCCAATTGA
TCCCAGCATGTCCCGACAC: CCCAGCATGTCCCGACACA
TCCCGACACATATTGTCGC: CCCGACACATATTGTCGCT
TCCCGCACGTCCAACATCA: CCCGCACGTCCAACATCAC
TCCCGGCTGACAGCTGCCT: CCCGGCTGACAGCTGCCTT
TCCCGGGGTATTAACTCGC: CCCGGGGTATTAACTCGCA
TCCCTGCGGCTACTCACTT: CCCTGCGGCTACTCACTTC
TCCCTTATGGACGAGCCAG: CCCTTATGGACGAGCCAGC
TCCGACCACAGAGTGAGGG: CCGACCACAGAGTGAGGGC
TCCGCACCGTAGTCAGTGA: CCGCACCGTAGTCAGTGAC
TCCGTAGGTGGATCTCCTC: CCGTAGGTGGATCTCCTCT
TCCGTGTCAACTGCGCCGC: CCGTGTCAACTGCGCCGCT
TCCGTGTCTATATTCGGGA: CCGTGTCTATATTCGGGAG
TCCTAATTGCTGTCATGCG: CCTAATTGCTGTCATGCGA
TCCTAGATCAGTGGTCGAG: CCTAGATCAGTGGTCGAGC
TCCTCTCGGGAGCTCCTAA: CCTCTCGGGAGCTCCTAAT
TCCTCTTCACGCACATCAC: CCTCTTCACGCACATCACG
TCCTCTTGGTGCGTGAAGT: CCTCTTGGTGCGTGAAGTA
TCCTGGAAACTTGGAGGCA: CCTGGAAACTTGGAGGCAA
TCCTGTATGACCCGATCAG: CCTGTATGACCCGATCAGT
TCCTGTATGTAAGTCGGGT: CCTGTATGTAAGTCGGGTA
TCCTGTGCAAAGCTAGCTA: CCTGTGCAAAGCTAGCTAG
TCCTTTCGTGTGACCATAT: CCTTTCGTGTGACCATATT
TCGAAAGCATAAATATTAA: CGAAAGCATAAATATTAAC
TCGAGCATGAAAGGCCAGC: CGAGCATGAAAGGCCAGCC
TCGAGCATGACGGTTGTTG: CGAGCATGACGGTTGTTGG
TCGAGCATGAGATGACTCA: CGAGCATGAGATGACTCAT
TCGAGCATGAGCCGAACTT: CGAGCATGAGCCGAACTTT
TCGAGTCCCTGCGGCTACT: CGAGTCCCTGCGGCTACTC
TCGATAGGCGGACGCGTCG: CGATAGGCGGACGCGTCGG
TCGATATGGTAGGTGTGAC: CGATATGGTAGGTGTGACT
TCGCAGATCTCATATCGGT: CGCAGATCTCATATCGGTT
TCGCAGATCTCCTGTATGA: CGCAGATCTCCTGTATGAC
TCGCAGATCTCGGCAGAAC: CGCAGATCTCGGCAGAACA
TCGCAGATCTCTACGGTTC: CGCAGATCTCTACGGTTCC
TCGCATGCTTGCGCTGTGA: CGCATGCTTGCGCTGTGAC
TCGCCTACCCCACTCGTGA: CGCCTACCCCACTCGTGAG
TCGCGATAAACATCGGGGC: CGCGATAAACATCGGGGCG
TCGCGATCGCGTAGGATCT: CGCGATCGCGTAGGATCTG
TCGCGCCCGTTATAATTAA: CGCGCCCGTTATAATTAAT
TCGCGTAGGATCTGACAGC: CGCGTAGGATCTGACAGCT
TCGCGTATATAGGCCCAAT: CGCGTATATAGGCCCAATA
TCGCTAGCGTCACCCGGAC: CGCTAGCGTCACCCGGACG
TCGCTAGGATAGTGACGCT: CGCTAGGATAGTGACGCTT
TCGGAACGAAGTAGAGCGG: CGGAACGAAGTAGAGCGGG
TCGGACGCATTGAGTACCT: CGGACGCATTGAGTACCTG
TCGGCAGAACATAGATCAG: CGGCAGAACATAGATCAGT
TCGGCCATATCGTGCTTAT: CGGCCATATCGTGCTTATA
TCGGCGTTTATCATAATTA: CGGCGTTTATCATAATTAG
TCGGCTAATCGCGCCCGTT: CGGCTAATCGCGCCCGTTA
TCGGGAGCCTAACGGGCGG: CGGGAGCCTAACGGGCGGG
TCGGGAGCTCCTAATTGCT: CGGGAGCTCCTAATTGCTG
TCGGGGCGGGAACCTGCTC: CGGGGCGGGAACCTGCTCA
TCGGGGTCGGGTCCCGGGG: CGGGGTCGGGTCCCGGGGT
TCGGGTATCATTGCAGGTG: CGGGTATCATTGCAGGTGA
TCGGGTCCCGGGGTATTAA: CGGGTCCCGGGGTATTAAC
TCGGTCAAAACTTATACAC: CGGTCAAAACTTATACACG
TCGGTCCGTAGGTGGATCT: CGGTCCGTAGGTGGATCTC
TCGGTTGCGATCAGTGGTC: CGGTTGCGATCAGTGGTCG
TCGTAGTCCACCATAATCT: CGTAGTCCACCATAATCTT
TCGTCCATATGGCCAGCAT: CGTCCATATGGCCAGCATC
TCGTCTTGGTAAGCGAACC: CGTCTTGGTAAGCGAACCC
TCGTGAGTATAACACCCAA: CGTGAGTATAACACCCAAT
TCGTGCGTGGTCGGTCCGT: CGTGCGTGGTCGGTCCGTA
TCGTGCTTATAACTATTTA: CGTGCTTATAACTATTTAC
TCGTGTACATTCACAAGCG: CGTGTACATTCACAAGCGT
TCGTGTGACCATATTACGC: CGTGTGACCATATTACGCG
TCGTTCGAAAGCATAAATA: CGTTCGAAAGCATAAATAT
TCTAAGCGCCTGCCACCAA: CTAAGCGCCTGCCACCAAC
TCTAATAATACAGTGTACA: CTAATAATACAGTGTACAC
TCTACGGTTCCTAGATCAG: CTACGGTTCCTAGATCAGT
TCTAGGCATCCGCACCGTA: CTAGGCATCCGCACCGTAG
TCTAGTTTTACTCTGTAAA: CTAGTTTTACTCTGTAAAC
TCTATATTCGGGAGCCTAA: CTATATTCGGGAGCCTAAC
TCTATCCTGTGCAAAGCTA: CTATCCTGTGCAAAGCTAG
TCTATCGTGTACATTCACA: CTATCGTGTACATTCACAA
TCTATTCGTGCGTGGTCGG: CTATTCGTGCGTGGTCGGT
TCTCATATCCGACCACAGA: CTCATATCCGACCACAGAG
TCTCATATCGGTTGCGATC: CTCATATCGGTTGCGATCA
TCTCCTCTTGGTGCGTGAA: CTCCTCTTGGTGCGTGAAG
TCTCCTGTATGACCCGATC: CTCCTGTATGACCCGATCA
TCTCGCCTACCCCACTCGT: CTCGCCTACCCCACTCGTG
TCTCGCGATCGCGTAGGAT: CTCGCGATCGCGTAGGATC
TCTCGGCAGAACATAGATC: CTCGGCAGAACATAGATCA
TCTCGGGAGCTCCTAATTG: CTCGGGAGCTCCTAATTGC
TCTCGGTCAAAACTTATAC: CTCGGTCAAAACTTATACA
TCTCTACGGTTCCTAGATC: CTCTACGGTTCCTAGATCA
TCTCTATTCGTGCGTGGTC: CTCTATTCGTGCGTGGTCG
TCTGAATGGGATTATCGAT: CTGAATGGGATTATCGATA
TCTGACAATTCTAGGCATC: CTGACAATTCTAGGCATCC
TCTGACAGCTGACCGCGGC: CTGACAGCTGACCGCGGCA
TCTGACGGCGGGCACTTAT: CTGACGGCGGGCACTTATG
TCTGGTCTTTATAAGTTTG: CTGGTCTTTATAAGTTTGA
TCTGTAAACGGTCTAAGCG: CTGTAAACGGTCTAAGCGC
TCTTCACGCACATCACGCA: CTTCACGCACATCACGCAT
TCTTCCAACATTTACAGAT: CTTCCAACATTTACAGATC
TCTTCCCACCTTTATCCAA: CTTCCCACCTTTATCCAAT
TCTTGAGAACTGCCCCACA: CTTGAGAACTGCCCCACAC
TCTTGGTAAGCGAACCCTA: CTTGGTAAGCGAACCCTAG
TCTTGGTGCGTGAAGTAGA: CTTGGTGCGTGAAGTAGAA
TCTTTAACGGCCGAAACAG: CTTTAACGGCCGAAACAGT
TCTTTATAAGTTTGAGTGA: CTTTATAAGTTTGAGTGAA
TCTTTCCCGCACGTCCAAC: CTTTCCCGCACGTCCAACA
TGAAAGGCCAGCCGGTCAA: GAAAGGCCAGCCGGTCAAC
TGAACTGGCGGGAAATACA: GAACTGGCGGGAAATACAT
TGAAGGCCGCTCTCGCGAT: GAAGGCCGCTCTCGCGATC
TGAAGTAGAACCCTCATTT: GAAGTAGAACCCTCATTTT
TGAATGCTCTTGAGAACTG: GAATGCTCTTGAGAACTGC
TGAATGGGATTATCGATAT: GAATGGGATTATCGATATG
TGACAATTCTAGGCATCCG: GACAATTCTAGGCATCCGC
TGACAGCTGACCGCGGCAT: GACAGCTGACCGCGGCATA
TGACAGCTGCCTTTGGGAT: GACAGCTGCCTTTGGGATA
TGACATATTATCGCTAGGA: GACATATTATCGCTAGGAT
TGACCAGTTATAGCTCCCT: GACCAGTTATAGCTCCCTT
TGACCATATTACGCGGTCG: GACCATATTACGCGGTCGC
TGACCCGATCAGTGGTCGA: GACCCGATCAGTGGTCGAG
TGACCCTCGTCTTGGTAAG: GACCCTCGTCTTGGTAAGC
TGACCCTTATCGCATGCTT: GACCCTTATCGCATGCTTG
TGACCGACTCGTCCATATG: GACCGACTCGTCCATATGG
TGACCGCGGCATACCCGAG: GACCGCGGCATACCCGAGG
TGACGAATGCCTTTGCCAT: GACGAATGCCTTTGCCATT
TGACGCCCTTTGATGCTCA: GACGCCCTTTGATGCTCAA
TGACGCTTTAGCAGTGTAA: GACGCTTTAGCAGTGTAAA
TGACGGCGGGCACTTATGC: GACGGCGGGCACTTATGCC
TGACGGTTGTTGGGGCTGA: GACGGTTGTTGGGGCTGAC
TGACGTGCGAGTTTCTTTA: GACGTGCGAGTTTCTTTAA
TGACTCATTAAGCGGACCA: GACTCATTAAGCGGACCAT
TGACTGTAATCGGCGTTTA: GACTGTAATCGGCGTTTAT
TGAGAACTGCCCCACACTG: GAGAACTGCCCCACACTGC
TGAGACATTATCAACTATT: GAGACATTATCAACTATTA
TGAGATGACTCATTAAGCG: GAGATGACTCATTAAGCGG
TGAGCCGAACTTTAATTAG: GAGCCGAACTTTAATTAGA
TGAGCGACGTAAGGGTAGA: GAGCGACGTAAGGGTAGAG
TGAGCGCTGATGTCGTTCG: GAGCGCTGATGTCGTTCGA
TGAGGGCCGCGGCGGGTGC: GAGGGCCGCGGCGGGTGCC
TGAGTACCTGTTGCTTTCA: GAGTACCTGTTGCTTTCAG
TGAGTATAACACCCAATAT: GAGTATAACACCCAATATC
TGAGTGAAGGCCGCTCTCG: GAGTGAAGGCCGCTCTCGC
TGATCCTGGAAACTTGGAG: GATCCTGGAAACTTGGAGG
TGATGCTCAAGGGGCTTGA: GATGCTCAAGGGGCTTGAC
TGATGTCGTTCGAAAGCAT: GATGTCGTTCGAAAGCATA
TGATGTGACGAATGCCTTT: GATGTGACGAATGCCTTTG
TGATGTGATCCTGGAAACT: GATGTGATCCTGGAAACTT
TGATTCTCGGTCAAAACTT: GATTCTCGGTCAAAACTTA
TGATTCTGGTCTTTATAAG: GATTCTGGTCTTTATAAGT
TGCAAAGCTAGCTAGGGGA: GCAAAGCTAGCTAGGGGAT
TGCACACGGCTTGGGCCAC: GCACACGGCTTGGGCCACG
TGCACGGCACAGCGCCCGG: GCACGGCACAGCGCCCGGG
TGCACGTCATCTTCCCACC: GCACGTCATCTTCCCACCT
TGCAGGTGAGACATTATCA: GCAGGTGAGACATTATCAA
TGCCACCAACGCCTGTTAT: GCCACCAACGCCTGTTATT
TGCCATCCCGGCTGACAGC: GCCATCCCGGCTGACAGCT
TGCCATTGCCGACTTCAAC: GCCATTGCCGACTTCAACA
TGCCCACCCGCATCCGTGT: GCCCACCCGCATCCGTGTC
TGCCCCACACTGCACGGCA: GCCCCACACTGCACGGCAC
TGCCGACTAATAGGGTTGT: GCCGACTAATAGGGTTGTA
TGCCGACTTCAACAATTCT: GCCGACTTCAACAATTCTC
TGCCGAGACGCTAGTATCG: GCCGAGACGCTAGTATCGT
TGCCTTTGCCATTGCCGAC: GCCTTTGCCATTGCCGACT
TGCCTTTGGGATACTTCCA: GCCTTTGGGATACTTCCAG
TGCGAGTTCTCTATTCGTG: GCGAGTTCTCTATTCGTGC
TGCGAGTTTCTTTAACGGC: GCGAGTTTCTTTAACGGCC
TGCGATCAGTGGTCGAGCA: GCGATCAGTGGTCGAGCAT
TGCGCCAAGCTGCCATCCC: GCGCCAAGCTGCCATCCCG
TGCGCCGCTGTATTCAATG: GCGCCGCTGTATTCAATGA
TGCGCTGTGACCAGTTATA: GCGCTGTGACCAGTTATAG
TGCGGCTACTCACTTCCTG: GCGGCTACTCACTTCCTGT
TGCGGGCGGGTCATCTGAC: GCGGGCGGGTCATCTGACA
TGCGTGAAGTAGAACCCTC: GCGTGAAGTAGAACCCTCA
TGCGTGGTCGGTCCGTAGG: GCGTGGTCGGTCCGTAGGT
TGCTCAAGGGGCTTGACGT: GCTCAAGGGGCTTGACGTG
TGCTCAATGGCCGCGCTGT: GCTCAATGGCCGCGCTGTT
TGCTCTAATAATACAGTGT: GCTCTAATAATACAGTGTA
TGCTCTTGAGAACTGCCCC: GCTCTTGAGAACTGCCCCA
TGCTGTCATGCGAGTTCTC: GCTGTCATGCGAGTTCTCT
TGCTTATAACTATTTACGG: GCTTATAACTATTTACGGT
TGCTTGCGCTGTGACCAGT: GCTTGCGCTGTGACCAGTT
TGCTTTCAGGCTGAACTGG: GCTTTCAGGCTGAACTGGC
TGGAAACTTGGAGGCAATG: GGAAACTTGGAGGCAATGA
TGGAAATCCTCTTCACGCA: GGAAATCCTCTTCACGCAC
TGGAATTCGAGTCCCTGCG: GGAATTCGAGTCCCTGCGG
TGGACGAGCCAGCCAAGCA: GGACGAGCCAGCCAAGCAT
TGGAGGCAATGATGTGACG: GGAGGCAATGATGTGACGA
TGGAGTTTAGAGGAAGAAA: GGAGTTTAGAGGAAGAAAG
TGGATAAAAGCAAACCCGT: GGATAAAAGCAAACCCGTA
TGGATCTCCTCTTGGTGCG: GGATCTCCTCTTGGTGCGT
TGGCCAGCATCCTTTCGTG: GGCCAGCATCCTTTCGTGT
TGGCCGCGCTGTTATGCTC: GGCCGCGCTGTTATGCTCT
TGGCGCATCGCGATAAACA: GGCGCATCGCGATAAACAT
TGGCGGGAAATACATGGCG: GGCGGGAAATACATGGCGC
TGGGATACTTCCAGCCTCA: GGGATACTTCCAGCCTCAG
TGGGATCCGTGTCTATATT: GGGATCCGTGTCTATATTC
TGGGATTATCGATATGGTA: GGGATTATCGATATGGTAG
TGGGCCACGGTAAGACTTG: GGGCCACGGTAAGACTTGG
TGGGGCTGACCCTCGTCTT: GGGGCTGACCCTCGTCTTG
TGGTAAGCGAACCCTAGGG: GGTAAGCGAACCCTAGGGG
TGGTAGGTGTGACTGTAAT: GGTAGGTGTGACTGTAATC
TGGTATTCCAAACTTAAAC: GGTATTCCAAACTTAAACT
TGGTCGAGCATGAAAGGCC: GGTCGAGCATGAAAGGCCA
TGGTCGAGCATGACGGTTG: GGTCGAGCATGACGGTTGT
TGGTCGAGCATGAGATGAC: GGTCGAGCATGAGATGACT
TGGTCGAGCATGAGCCGAA: GGTCGAGCATGAGCCGAAC
TGGTCGGTCCGTAGGTGGA: GGTCGGTCCGTAGGTGGAT
TGGTCTTTATAAGTTTGAG: GGTCTTTATAAGTTTGAGT
TGGTGCGTGAAGTAGAACC: GGTGCGTGAAGTAGAACCC
TGTAAACGGTCTAAGCGCC: GTAAACGGTCTAAGCGCCT
TGTAAAGAGTGGATAAAAG: GTAAAGAGTGGATAAAAGC
TGTAACAGGCTAGATACTG: GTAACAGGCTAGATACTGT
TGTAACGTAACGATAGCGA: GTAACGTAACGATAGCGAA
TGTAAGTCGGGTATCATTG: GTAAGTCGGGTATCATTGC
TGTAATCGGCGTTTATCAT: GTAATCGGCGTTTATCATA
TGTACACACGAATCTGAAT: GTACACACGAATCTGAATG
TGTACATTCACAAGCGTTC: GTACATTCACAAGCGTTCG
TGTATGACCCGATCAGTGG: GTATGACCCGATCAGTGGT
TGTATGTAAGTCGGGTATC: GTATGTAAGTCGGGTATCA
TGTATTCAATGATTCTCGG: GTATTCAATGATTCTCGGT
TGTCAACTGCGCCGCTGTA: GTCAACTGCGCCGCTGTAT
TGTCATGCGAGTTCTCTAT: GTCATGCGAGTTCTCTATT
TGTCCCGACACATATTGTC: GTCCCGACACATATTGTCG
TGTCGATAGGCGGACGCGT: GTCGATAGGCGGACGCGTC
TGTCGCTAGCGTCACCCGG: GTCGCTAGCGTCACCCGGA
TGTCGTTCGAAAGCATAAA: GTCGTTCGAAAGCATAAAT
TGTCTATATTCGGGAGCCT: GTCTATATTCGGGAGCCTA
TGTGACCAGTTATAGCTCC: GTGACCAGTTATAGCTCCC
TGTGACCATATTACGCGGT: GTGACCATATTACGCGGTC
TGTGACCCTTATCGCATGC: GTGACCCTTATCGCATGCT
TGTGACGAATGCCTTTGCC: GTGACGAATGCCTTTGCCA
TGTGACTGTAATCGGCGTT: GTGACTGTAATCGGCGTTT
TGTGAGCGCTGATGTCGTT: GTGAGCGCTGATGTCGTTC
TGTGATCCTGGAAACTTGG: GTGATCCTGGAAACTTGGA
TGTGCAAAGCTAGCTAGGG: GTGCAAAGCTAGCTAGGGG
TGTTATGCTCTAATAATAC: GTTATGCTCTAATAATACA
TGTTATTAACTCGCAGATC: GTTATTAACTCGCAGATCT
TGTTGCTTTCAGGCTGAAC: GTTGCTTTCAGGCTGAACT
TGTTGGGGCTGACCCTCGT: GTTGGGGCTGACCCTCGTC
TGTTGTGACCCTTATCGCA: GTTGTGACCCTTATCGCAT
TTAACGGCCGAAACAGTTT: TAACGGCCGAAACAGTTTG
TTAACTCGCAGATCTCATA: TAACTCGCAGATCTCATAT
TTAACTCGCAGATCTCCTG: TAACTCGCAGATCTCCTGT
TTAACTCGCAGATCTCGGC: TAACTCGCAGATCTCGGCA
TTAACTCGCAGATCTCTAC: TAACTCGCAGATCTCTACG
TTAAGCGGACCATCTTTCC: TAAGCGGACCATCTTTCCC
TTAAGCTGTAACAGGCTAG: TAAGCTGTAACAGGCTAGA
TTAATAAGAATCTATCGTG: TAATAAGAATCTATCGTGT
TTAATTAGATGGTATTCCA: TAATTAGATGGTATTCCAA
TTAATTTCGGGGTCGGGTC: TAATTTCGGGGTCGGGTCC
TTACAGATCTAGTTTTACT: TACAGATCTAGTTTTACTC
TTACGCGGTCGCGTATATA: TACGCGGTCGCGTATATAG
TTACGGCACTATTTGCACA: TACGGCACTATTTGCACAC
TTACGGTTATGCCCACCCG: TACGGTTATGCCCACCCGC
TTACTCTGTAAACGGTCTA: TACTCTGTAAACGGTCTAA
TTAGACTGCGGGCGGGTCA: TAGACTGCGGGCGGGTCAT
TTAGAGGAAGAAAGGCTCG: TAGAGGAAGAAAGGCTCGG
TTAGATGGTATTCCAAACT: TAGATGGTATTCCAAACTT
TTAGCAGTGTAAAGAGTGG: TAGCAGTGTAAAGAGTGGA
TTAGCCTACTACTTGCACG: TAGCCTACTACTTGCACGT
TTATAACTATTTACGGTTA: TATAACTATTTACGGTTAT
TTATAAGTTTGAGTGAAGG: TATAAGTTTGAGTGAAGGC
TTATAATTAATAAGAATCT: TATAATTAATAAGAATCTA
TTATACACGCCAATTTGAG: TATACACGCCAATTTGAGC
TTATAGCTCCCTTATGGAC: TATAGCTCCCTTATGGACG
TTATCAACTATTAACTCGC: TATCAACTATTAACTCGCA
TTATCATAATTAGCCTACT: TATCATAATTAGCCTACTA
TTATCCAATTGACGCCCTT: TATCCAATTGACGCCCTTT
TTATCGATATGGTAGGTGT: TATCGATATGGTAGGTGTG
TTATCGCATGCTTGCGCTG: TATCGCATGCTTGCGCTGT
TTATCGCTAGGATAGTGAC: TATCGCTAGGATAGTGACG
TTATCTCATATCCGACCAC: TATCTCATATCCGACCACA
TTATGCCCACCCGCATCCG: TATGCCCACCCGCATCCGT
TTATGCCGACTAATAGGGT: TATGCCGACTAATAGGGTT
TTATGCTCTAATAATACAG: TATGCTCTAATAATACAGT
TTATGGACGAGCCAGCCAA: TATGGACGAGCCAGCCAAG
TTATTAACTCGCAGATCTC: TATTAACTCGCAGATCTCT
TTCAAAGGCCTGCGCCAAG: TCAAAGGCCTGCGCCAAGC
TTCAACAATTCTCGCCTAC: TCAACAATTCTCGCCTACC
TTCAATGATTCTCGGTCAA: TCAATGATTCTCGGTCAAA
TTCACAAGCGTTCGGACGC: TCACAAGCGTTCGGACGCA
TTCACGCACATCACGCATA: TCACGCACATCACGCATAC
TTCAGGCTGAACTGGCGGG: TCAGGCTGAACTGGCGGGA
TTCATACATCAACAAGCTA: TCATACATCAACAAGCTAG
TTCCAACATTTACAGATCT: TCCAACATTTACAGATCTA
TTCCAGCCTCAGTTACGGC: TCCAGCCTCAGTTACGGCA
TTCCCACCTTTATCCAATT: TCCCACCTTTATCCAATTG
TTCCCGCACGTCCAACATC: TCCCGCACGTCCAACATCA
TTCCTAGATCAGTGGTCGA: TCCTAGATCAGTGGTCGAG
TTCCTGTATGTAAGTCGGG: TCCTGTATGTAAGTCGGGT
TTCGAAAGCATAAATATTA: TCGAAAGCATAAATATTAA
TTCGAGTCCCTGCGGCTAC: TCGAGTCCCTGCGGCTACT
TTCGGACGCATTGAGTACC: TCGGACGCATTGAGTACCT
TTCGGGAGCCTAACGGGCG: TCGGGAGCCTAACGGGCGG
TTCGGGGTCGGGTCCCGGG: TCGGGGTCGGGTCCCGGGG
TTCGTGCGTGGTCGGTCCG: TCGTGCGTGGTCGGTCCGT
TTCGTGTGACCATATTACG: TCGTGTGACCATATTACGC
TTCTAGGCATCCGCACCGT: TCTAGGCATCCGCACCGTA
TTCTCGCCTACCCCACTCG: TCTCGCCTACCCCACTCGT
TTCTCGGTCAAAACTTATA: TCTCGGTCAAAACTTATAC
TTCTCTATTCGTGCGTGGT: TCTCTATTCGTGCGTGGTC
TTCTGGTCTTTATAAGTTT: TCTGGTCTTTATAAGTTTG
TTCTTTAACGGCCGAAACA: TCTTTAACGGCCGAAACAG
TTGACCGACTCGTCCATAT: TGACCGACTCGTCCATATG
TTGACGCCCTTTGATGCTC: TGACGCCCTTTGATGCTCA
TTGACGTGCGAGTTTCTTT: TGACGTGCGAGTTTCTTTA
TTGAGAACTGCCCCACACT: TGAGAACTGCCCCACACTG
TTGAGCGACGTAAGGGTAG: TGAGCGACGTAAGGGTAGA
TTGAGTACCTGTTGCTTTC: TGAGTACCTGTTGCTTTCA
TTGAGTGAAGGCCGCTCTC: TGAGTGAAGGCCGCTCTCG
TTGATGCTCAAGGGGCTTG: TGATGCTCAAGGGGCTTGA
TTGATGTGATCCTGGAAAC: TGATGTGATCCTGGAAACT
TTGCACACGGCTTGGGCCA: TGCACACGGCTTGGGCCAC
TTGCACGTCATCTTCCCAC: TGCACGTCATCTTCCCACC
TTGCAGGTGAGACATTATC: TGCAGGTGAGACATTATCA
TTGCCATTGCCGACTTCAA: TGCCATTGCCGACTTCAAC
TTGCCGACTTCAACAATTC: TGCCGACTTCAACAATTCT
TTGCGATCAGTGGTCGAGC: TGCGATCAGTGGTCGAGCA
TTGCGCTGTGACCAGTTAT: TGCGCTGTGACCAGTTATA
TTGCTGTCATGCGAGTTCT: TGCTGTCATGCGAGTTCTC
TTGCTTTCAGGCTGAACTG: TGCTTTCAGGCTGAACTGG
TTGGAAATCCTCTTCACGC: TGGAAATCCTCTTCACGCA
TTGGAGGCAATGATGTGAC: TGGAGGCAATGATGTGACG
TTGGGATACTTCCAGCCTC: TGGGATACTTCCAGCCTCA
TTGGGCCACGGTAAGACTT: TGGGCCACGGTAAGACTTG
TTGGGGCTGACCCTCGTCT: TGGGGCTGACCCTCGTCTT
TTGGTAAGCGAACCCTAGG: TGGTAAGCGAACCCTAGGG
TTGGTGCGTGAAGTAGAAC: TGGTGCGTGAAGTAGAACC
TTGTAACGTAACGATAGCG: TGTAACGTAACGATAGCGA
TTGTCGATAGGCGGACGCG: TGTCGATAGGCGGACGCGT
TTGTCGCTAGCGTCACCCG: TGTCGCTAGCGTCACCCGG
TTGTGACCCTTATCGCATG: TGTGACCCTTATCGCATGC
TTGTTGGGGCTGACCCTCG: TGTTGGGGCTGACCCTCGT
TTTAACGGCCGAAACAGTT: TTAACGGCCGAAACAGTTT
TTTAATTAGATGGTATTCC: TTAATTAGATGGTATTCCA
TTTACAGATCTAGTTTTAC: TTACAGATCTAGTTTTACT
TTTACGGTTATGCCCACCC: TTACGGTTATGCCCACCCG
TTTACTCTGTAAACGGTCT: TTACTCTGTAAACGGTCTA
TTTAGAGGAAGAAAGGCTC: TTAGAGGAAGAAAGGCTCG
TTTAGCAGTGTAAAGAGTG: TTAGCAGTGTAAAGAGTGG
TTTATAAGTTTGAGTGAAG: TTATAAGTTTGAGTGAAGG
TTTATCATAATTAGCCTAC: TTATCATAATTAGCCTACT
TTTATCCAATTGACGCCCT: TTATCCAATTGACGCCCTT
TTTATCTCATATCCGACCA: TTATCTCATATCCGACCAC
TTTCAGGCTGAACTGGCGG: TTCAGGCTGAACTGGCGGG
TTTCCCGCACGTCCAACAT: TTCCCGCACGTCCAACATC
TTTCGGGGTCGGGTCCCGG: TTCGGGGTCGGGTCCCGGG
TTTCGTGTGACCATATTAC: TTCGTGTGACCATATTACG
TTTCTTTAACGGCCGAAAC: TTCTTTAACGGCCGAAACA
TTTGACCGACTCGTCCATA: TTGACCGACTCGTCCATAT
TTTGAGCGACGTAAGGGTA: TTGAGCGACGTAAGGGTAG
TTTGAGTGAAGGCCGCTCT: TTGAGTGAAGGCCGCTCTC
TTTGATGCTCAAGGGGCTT: TTGATGCTCAAGGGGCTTG
TTTGCACACGGCTTGGGCC: TTGCACACGGCTTGGGCCA
TTTGCCATTGCCGACTTCA: TTGCCATTGCCGACTTCAA
TTTGGGATACTTCCAGCCT: TTGGGATACTTCCAGCCTC
TTTTACTCTGTAAACGGTC: TTTACTCTGTAAACGGTCT
TTTTATCTCATATCCGACC: TTTATCTCATATCCGACCA
